"","ID","trialno","condition","rt","self_poss_loss","other_poss_loss","diff_diff","resp_code"
"85","0",1,"control",1913,320,220,540,1
"86","0",2,"control",1661,380,20,400,1
"87","0",3,"control",1487,240,300,540,0
"88","0",4,"control",1402,380,20,400,0
"89","0",5,"control",2200,100,380,480,0
"90","0",6,"control",2223,220,320,540,1
"91","0",7,"multi-motive",1327,340,180,520,1
"92","0",8,"multi-motive",1344,300,240,540,1
"93","0",9,"multi-motive",1106,380,60,440,1
"94","0",10,"control",2155,380,40,420,0
"95","0",11,"control",1387,100,380,480,1
"97","0",13,"multi-motive",1423,380,100,480,1
"98","0",14,"multi-motive",2264,380,40,420,1
"100","0",16,"control",1215,220,320,540,1
"102","0",18,"control",1597,380,60,440,1
"103","0",19,"control",1264,180,340,520,0
"104","0",20,"control",1678,380,100,480,1
"105","0",21,"control",1021,300,240,540,1
"106","0",22,"control",2079,380,100,480,1
"107","0",23,"control",967,20,380,400,1
"108","0",24,"control",2007,60,380,440,0
"109","0",25,"control",1060,180,340,520,1
"110","0",26,"control",1244,360,160,520,1
"111","0",27,"control",1264,320,220,540,0
"113","0",29,"control",1158,120,360,480,0
"114","0",30,"control",1207,360,160,520,0
"115","0",31,"multi-motive",910,100,380,480,1
"116","0",32,"multi-motive",1098,380,60,440,1
"117","0",33,"multi-motive",1243,180,340,520,1
"118","0",34,"control",1402,340,180,520,1
"120","0",36,"control",1543,160,360,520,0
"121","0",37,"multi-motive",1021,220,320,540,1
"122","0",38,"multi-motive",1142,380,40,420,1
"123","0",39,"multi-motive",1003,20,380,400,1
"125","0",41,"multi-motive",1386,60,380,440,1
"127","0",43,"control",1433,240,300,540,1
"128","0",44,"control",1311,120,360,480,1
"129","0",45,"control",1017,40,380,420,0
"130","0",46,"multi-motive",1155,240,300,540,1
"131","0",47,"multi-motive",884,360,120,480,1
"132","0",48,"multi-motive",805,280,280,560,1
"133","0",49,"multi-motive",707,380,20,400,1
"134","0",50,"multi-motive",1236,180,340,520,1
"135","0",51,"multi-motive",969,320,220,540,1
"137","0",53,"multi-motive",1816,40,380,420,1
"138","0",54,"multi-motive",2106,300,240,540,1
"139","0",55,"multi-motive",953,40,380,420,1
"140","0",56,"multi-motive",1446,380,20,400,1
"141","0",57,"multi-motive",1072,280,280,560,1
"142","0",58,"multi-motive",1270,20,380,400,1
"143","0",59,"multi-motive",1082,60,380,440,1
"144","0",60,"multi-motive",869,320,220,540,1
"145","0",61,"multi-motive",904,240,300,540,1
"146","0",62,"multi-motive",1020,340,180,520,1
"147","0",63,"multi-motive",960,220,320,540,1
"148","0",64,"multi-motive",791,160,360,520,1
"149","0",65,"multi-motive",1269,360,120,480,1
"150","0",66,"multi-motive",832,120,360,480,1
"151","0",67,"multi-motive",2110,360,160,520,1
"152","0",68,"multi-motive",1079,360,160,520,1
"153","0",69,"multi-motive",856,380,100,480,1
"154","0",70,"control",1855,280,280,560,1
"155","0",71,"control",1020,360,120,480,0
"156","0",72,"control",1149,60,380,440,1
"157","0",73,"control",989,280,280,560,0
"158","0",74,"control",1090,300,240,540,0
"159","0",75,"control",1417,160,360,520,1
"160","0",76,"multi-motive",1450,120,360,480,1
"161","0",77,"multi-motive",842,100,380,480,1
"162","0",78,"multi-motive",1764,160,360,520,1
"163","0",79,"control",1105,40,380,420,1
"164","0",80,"control",1098,20,380,400,0
"165","0",81,"control",1256,360,120,480,0
"166","0",82,"control",835,380,40,420,1
"167","0",83,"control",883,380,60,440,0
"168","0",84,"control",834,340,180,520,1
"421","1",1,"reciprocity",1149,240,300,540,0
"422","1",2,"reciprocity",1422,160,360,520,1
"423","1",3,"reciprocity",1387,100,380,480,1
"424","1",4,"empathy",1875,100,380,480,0
"425","1",5,"empathy",2665,380,60,440,1
"426","1",6,"empathy",1413,160,360,520,1
"427","1",7,"empathy",2510,120,360,480,0
"428","1",8,"empathy",1386,380,20,400,1
"429","1",9,"empathy",1747,280,280,560,1
"430","1",10,"reciprocity",1877,380,40,420,1
"431","1",11,"reciprocity",2618,340,180,520,1
"432","1",12,"reciprocity",2671,360,120,480,0
"433","1",13,"reciprocity",1392,40,380,420,1
"434","1",14,"reciprocity",1276,60,380,440,1
"436","1",16,"empathy",1478,40,380,420,1
"437","1",17,"empathy",2766,280,280,560,1
"438","1",18,"empathy",1838,380,100,480,0
"439","1",19,"reciprocity",2102,340,180,520,0
"440","1",20,"reciprocity",1316,20,380,400,1
"441","1",21,"reciprocity",2610,60,380,440,0
"442","1",22,"reciprocity",3011,220,320,540,1
"443","1",23,"reciprocity",2191,380,60,440,0
"444","1",24,"reciprocity",2240,40,380,420,0
"445","1",25,"reciprocity",1660,380,60,440,0
"446","1",26,"reciprocity",3793,380,40,420,0
"447","1",27,"reciprocity",2063,360,160,520,0
"448","1",28,"reciprocity",1767,240,300,540,1
"449","1",29,"reciprocity",2123,380,20,400,0
"450","1",30,"reciprocity",2334,380,20,400,1
"451","1",31,"empathy",2453,360,160,520,1
"452","1",32,"empathy",3031,380,40,420,1
"453","1",33,"empathy",2886,360,120,480,1
"454","1",34,"empathy",2376,160,360,520,0
"455","1",35,"empathy",3319,120,360,480,0
"456","1",36,"empathy",2372,380,40,420,1
"457","1",37,"reciprocity",1923,380,100,480,1
"458","1",38,"reciprocity",2653,380,100,480,1
"460","1",40,"empathy",2257,60,380,440,1
"461","1",41,"empathy",1659,320,220,540,1
"463","1",43,"empathy",1788,20,380,400,1
"464","1",44,"empathy",2022,220,320,540,0
"465","1",45,"empathy",1127,320,220,540,1
"466","1",46,"reciprocity",1456,120,360,480,1
"467","1",47,"reciprocity",1721,280,280,560,1
"468","1",48,"reciprocity",3302,180,340,520,1
"469","1",49,"reciprocity",1293,160,360,520,1
"471","1",51,"reciprocity",2482,300,240,540,1
"472","1",52,"reciprocity",2502,180,340,520,1
"473","1",53,"reciprocity",1627,360,160,520,0
"474","1",54,"reciprocity",1530,280,280,560,1
"475","1",55,"empathy",1812,360,160,520,1
"477","1",57,"empathy",1841,180,340,520,1
"478","1",58,"empathy",1807,340,180,520,1
"480","1",60,"empathy",3249,240,300,540,0
"481","1",61,"reciprocity",2638,360,120,480,0
"483","1",63,"reciprocity",1521,220,320,540,1
"484","1",64,"empathy",1592,100,380,480,1
"485","1",65,"empathy",1325,60,380,440,1
"486","1",66,"empathy",2736,380,100,480,1
"487","1",67,"empathy",2472,40,380,420,1
"488","1",68,"empathy",2366,180,340,520,1
"489","1",69,"empathy",1017,380,60,440,0
"490","1",70,"reciprocity",2071,300,240,540,0
"491","1",71,"reciprocity",2022,20,380,400,1
"492","1",72,"reciprocity",1687,320,220,540,1
"493","1",73,"empathy",1919,240,300,540,0
"494","1",74,"empathy",1204,20,380,400,1
"496","1",76,"empathy",1717,300,240,540,1
"497","1",77,"empathy",1995,380,20,400,1
"498","1",78,"empathy",1981,360,120,480,1
"499","1",79,"empathy",2163,220,320,540,1
"500","1",80,"empathy",1941,300,240,540,1
"501","1",81,"empathy",1927,340,180,520,0
"502","1",82,"reciprocity",2455,100,380,480,1
"503","1",83,"reciprocity",1793,120,360,480,1
"504","1",84,"reciprocity",1697,320,220,540,1
"589","2",1,"reciprocity",1656,380,100,480,0
"590","2",2,"reciprocity",1852,180,340,520,0
"591","2",3,"reciprocity",1704,60,380,440,1
"592","2",4,"empathy",1929,60,380,440,1
"593","2",5,"empathy",1609,120,360,480,1
"594","2",6,"empathy",1876,340,180,520,0
"595","2",7,"reciprocity",1999,160,360,520,0
"596","2",8,"reciprocity",2438,20,380,400,1
"597","2",9,"reciprocity",2093,240,300,540,1
"598","2",10,"reciprocity",2118,320,220,540,1
"599","2",11,"reciprocity",2004,380,20,400,0
"600","2",12,"reciprocity",1821,360,160,520,0
"601","2",13,"reciprocity",1556,20,380,400,1
"602","2",14,"reciprocity",1848,280,280,560,0
"603","2",15,"reciprocity",1425,40,380,420,1
"604","2",16,"empathy",1017,60,380,440,1
"605","2",17,"empathy",1831,320,220,540,1
"606","2",18,"empathy",2213,380,100,480,0
"607","2",19,"reciprocity",2252,380,60,440,0
"608","2",20,"reciprocity",2507,380,60,440,0
"610","2",22,"reciprocity",1659,380,20,400,0
"611","2",23,"reciprocity",2031,340,180,520,0
"612","2",24,"reciprocity",1935,220,320,540,0
"613","2",25,"reciprocity",1103,380,40,420,0
"614","2",26,"reciprocity",1098,360,120,480,0
"615","2",27,"reciprocity",1503,100,380,480,0
"616","2",28,"empathy",1697,240,300,540,1
"617","2",29,"empathy",1884,280,280,560,1
"618","2",30,"empathy",1697,40,380,420,1
"619","2",31,"reciprocity",1617,240,300,540,0
"620","2",32,"reciprocity",2407,40,380,420,1
"621","2",33,"reciprocity",1463,340,180,520,0
"622","2",34,"empathy",2004,300,240,540,0
"623","2",35,"empathy",1933,280,280,560,1
"624","2",36,"empathy",1385,380,100,480,0
"625","2",37,"empathy",2083,180,340,520,0
"627","2",39,"empathy",1735,380,60,440,0
"628","2",40,"empathy",1806,360,160,520,0
"629","2",41,"empathy",2537,360,160,520,1
"630","2",42,"empathy",1744,360,120,480,0
"631","2",43,"empathy",1787,320,220,540,0
"633","2",45,"empathy",1873,160,360,520,1
"635","2",47,"reciprocity",2109,120,360,480,0
"636","2",48,"reciprocity",2053,280,280,560,1
"637","2",49,"empathy",1649,380,40,420,0
"638","2",50,"empathy",2390,100,380,480,1
"640","2",52,"empathy",1149,380,60,440,0
"641","2",53,"empathy",1702,360,120,480,1
"642","2",54,"empathy",1401,180,340,520,1
"643","2",55,"reciprocity",1446,120,360,480,1
"644","2",56,"reciprocity",2058,360,160,520,0
"645","2",57,"reciprocity",2041,160,360,520,0
"647","2",59,"empathy",949,300,240,540,0
"648","2",60,"empathy",2062,120,360,480,0
"649","2",61,"reciprocity",1905,320,220,540,0
"650","2",62,"reciprocity",2134,60,380,440,1
"651","2",63,"reciprocity",1308,380,100,480,0
"652","2",64,"reciprocity",1962,360,120,480,0
"654","2",66,"reciprocity",1584,300,240,540,0
"656","2",68,"empathy",1464,20,380,400,1
"657","2",69,"empathy",885,40,380,420,1
"658","2",70,"empathy",1182,380,40,420,0
"659","2",71,"empathy",1370,340,180,520,0
"660","2",72,"empathy",1423,380,20,400,0
"661","2",73,"empathy",1358,100,380,480,1
"662","2",74,"empathy",1142,160,360,520,1
"663","2",75,"empathy",2039,240,300,540,0
"664","2",76,"empathy",1196,220,320,540,0
"665","2",77,"empathy",1095,380,20,400,0
"666","2",78,"empathy",2412,20,380,400,1
"667","2",79,"reciprocity",2120,180,340,520,1
"668","2",80,"reciprocity",1829,380,40,420,0
"669","2",81,"reciprocity",3128,220,320,540,1
"672","2",84,"reciprocity",2054,300,240,540,1
"673","3",1,"multi-motive",1494,20,380,400,1
"674","3",2,"multi-motive",2783,380,60,440,0
"676","3",4,"control",1140,280,280,560,1
"677","3",5,"control",933,120,360,480,1
"678","3",6,"control",2124,180,340,520,1
"679","3",7,"multi-motive",1700,160,360,520,1
"680","3",8,"multi-motive",1397,20,380,400,1
"681","3",9,"multi-motive",2161,380,100,480,0
"682","3",10,"multi-motive",1260,360,160,520,1
"683","3",11,"multi-motive",1271,240,300,540,1
"684","3",12,"multi-motive",1446,220,320,540,1
"685","3",13,"multi-motive",1868,40,380,420,1
"686","3",14,"multi-motive",1576,360,120,480,0
"687","3",15,"multi-motive",911,120,360,480,1
"688","3",16,"control",1337,20,380,400,1
"689","3",17,"control",1207,360,120,480,1
"690","3",18,"control",1013,40,380,420,1
"692","3",20,"control",2631,380,100,480,1
"693","3",21,"control",859,360,160,520,1
"694","3",22,"multi-motive",925,300,240,540,1
"695","3",23,"multi-motive",824,340,180,520,1
"696","3",24,"multi-motive",909,280,280,560,1
"697","3",25,"multi-motive",1011,380,40,420,1
"698","3",26,"multi-motive",886,380,60,440,1
"699","3",27,"multi-motive",939,360,120,480,1
"700","3",28,"multi-motive",937,40,380,420,1
"701","3",29,"multi-motive",2087,320,220,540,1
"702","3",30,"multi-motive",1910,380,100,480,0
"703","3",31,"multi-motive",3541,380,20,400,0
"705","3",33,"multi-motive",3283,100,380,480,1
"706","3",34,"control",2416,380,40,420,0
"707","3",35,"control",1795,100,380,480,1
"708","3",36,"control",2853,380,100,480,1
"709","3",37,"control",1572,120,360,480,1
"710","3",38,"control",2563,380,20,400,0
"711","3",39,"control",1584,380,60,440,0
"714","3",42,"multi-motive",1390,180,340,520,1
"716","3",44,"control",2540,240,300,540,1
"717","3",45,"control",1811,220,320,540,0
"718","3",46,"multi-motive",2341,160,360,520,1
"719","3",47,"multi-motive",2403,240,300,540,1
"720","3",48,"multi-motive",2960,380,40,420,0
"721","3",49,"multi-motive",3327,340,180,520,0
"722","3",50,"multi-motive",2284,280,280,560,1
"723","3",51,"multi-motive",1972,220,320,540,1
"724","3",52,"control",1617,60,380,440,1
"725","3",53,"control",2860,340,180,520,0
"728","3",56,"control",1839,220,320,540,1
"729","3",57,"control",2919,320,220,540,1
"730","3",58,"control",2999,300,240,540,1
"732","3",60,"control",2763,160,360,520,1
"733","3",61,"control",3912,240,300,540,0
"734","3",62,"control",1049,40,380,420,1
"735","3",63,"control",2441,360,160,520,0
"736","3",64,"multi-motive",2141,320,220,540,1
"737","3",65,"multi-motive",1217,100,380,480,1
"738","3",66,"multi-motive",1309,120,360,480,1
"740","3",68,"multi-motive",2427,380,20,400,0
"741","3",69,"multi-motive",1313,60,380,440,1
"742","3",70,"control",1381,280,280,560,1
"743","3",71,"control",3185,300,240,540,0
"744","3",72,"control",861,60,380,440,1
"745","3",73,"control",1642,340,180,520,1
"746","3",74,"control",1520,320,220,540,0
"747","3",75,"control",1803,20,380,400,1
"748","3",76,"control",1248,380,40,420,0
"749","3",77,"control",1209,380,20,400,0
"750","3",78,"control",1227,160,360,520,1
"751","3",79,"multi-motive",1326,360,160,520,0
"752","3",80,"multi-motive",2148,300,240,540,1
"753","3",81,"multi-motive",1229,60,380,440,1
"754","3",82,"control",1584,380,60,440,0
"755","3",83,"control",994,100,380,480,1
"756","3",84,"control",1840,360,120,480,0
"758","4",2,"control",2370,100,380,480,1
"760","4",4,"control",2806,280,280,560,1
"763","4",7,"control",3507,240,300,540,1
"764","4",8,"control",3571,40,380,420,1
"765","4",9,"control",2237,120,360,480,1
"766","4",10,"control",2785,60,380,440,1
"767","4",11,"control",2821,380,40,420,1
"768","4",12,"control",1470,340,180,520,1
"769","4",13,"multi-motive",2101,40,380,420,1
"770","4",14,"multi-motive",1409,220,320,540,1
"771","4",15,"multi-motive",2669,380,40,420,1
"772","4",16,"multi-motive",964,180,340,520,1
"773","4",17,"multi-motive",1785,300,240,540,1
"774","4",18,"multi-motive",1314,380,40,420,1
"775","4",19,"multi-motive",1197,340,180,520,1
"776","4",20,"multi-motive",1549,180,340,520,1
"777","4",21,"multi-motive",1408,320,220,540,1
"778","4",22,"multi-motive",1053,280,280,560,1
"779","4",23,"multi-motive",1275,60,380,440,1
"780","4",24,"multi-motive",1539,280,280,560,1
"781","4",25,"multi-motive",842,160,360,520,1
"782","4",26,"multi-motive",1219,160,360,520,1
"784","4",28,"control",1176,360,160,520,1
"786","4",30,"control",906,20,380,400,1
"787","4",31,"control",1141,320,220,540,1
"788","4",32,"control",1322,340,180,520,1
"789","4",33,"control",1014,220,320,540,1
"790","4",34,"multi-motive",1097,380,100,480,1
"791","4",35,"multi-motive",1059,20,380,400,1
"792","4",36,"multi-motive",915,360,120,480,1
"793","4",37,"multi-motive",1027,40,380,420,1
"794","4",38,"multi-motive",1074,100,380,480,1
"795","4",39,"multi-motive",1954,20,380,400,1
"796","4",40,"multi-motive",1870,120,360,480,1
"797","4",41,"multi-motive",1933,380,60,440,1
"798","4",42,"multi-motive",2034,380,100,480,1
"799","4",43,"multi-motive",1319,300,240,540,1
"800","4",44,"multi-motive",1116,340,180,520,1
"801","4",45,"multi-motive",1943,360,160,520,1
"802","4",46,"control",1803,220,320,540,1
"803","4",47,"control",1912,20,380,400,1
"804","4",48,"control",1754,320,220,540,1
"805","4",49,"control",2008,60,380,440,1
"806","4",50,"control",1088,280,280,560,1
"807","4",51,"control",796,380,100,480,1
"808","4",52,"multi-motive",1335,100,380,480,1
"809","4",53,"multi-motive",1502,360,120,480,1
"811","4",55,"control",1847,160,360,520,1
"812","4",56,"control",1107,120,360,480,1
"813","4",57,"control",2220,380,60,440,1
"814","4",58,"multi-motive",1038,240,300,540,1
"815","4",59,"multi-motive",823,120,360,480,1
"816","4",60,"multi-motive",1193,380,20,400,1
"818","4",62,"multi-motive",924,60,380,440,1
"819","4",63,"multi-motive",838,360,160,520,1
"820","4",64,"control",1157,300,240,540,1
"821","4",65,"control",1186,40,380,420,1
"822","4",66,"control",692,240,300,540,1
"823","4",67,"control",689,180,340,520,1
"824","4",68,"control",902,100,380,480,1
"825","4",69,"control",1007,380,60,440,1
"826","4",70,"control",731,360,120,480,1
"828","4",72,"control",1591,160,360,520,1
"829","4",73,"control",901,180,340,520,1
"830","4",74,"control",1681,380,100,480,1
"831","4",75,"control",797,380,40,420,1
"832","4",76,"control",1931,380,20,400,1
"833","4",77,"control",938,380,20,400,1
"834","4",78,"control",808,300,240,540,1
"835","4",79,"multi-motive",1015,220,320,540,1
"836","4",80,"multi-motive",2294,380,20,400,1
"837","4",81,"multi-motive",1305,320,220,540,1
"839","4",83,"multi-motive",1548,380,60,440,1
"840","4",84,"multi-motive",972,240,300,540,1
"841","5",1,"multi-motive",1926,380,40,420,1
"842","5",2,"multi-motive",2379,240,300,540,1
"844","5",4,"multi-motive",1658,280,280,560,1
"845","5",5,"multi-motive",2093,280,280,560,1
"846","5",6,"multi-motive",1873,320,220,540,1
"847","5",7,"control",1982,300,240,540,1
"848","5",8,"control",1556,340,180,520,1
"849","5",9,"control",1998,280,280,560,1
"850","5",10,"multi-motive",2126,360,160,520,1
"851","5",11,"multi-motive",1637,20,380,400,1
"852","5",12,"multi-motive",1917,180,340,520,1
"854","5",14,"control",1087,180,340,520,1
"855","5",15,"control",1821,240,300,540,1
"856","5",16,"control",1993,380,40,420,1
"857","5",17,"control",1757,380,100,480,1
"858","5",18,"control",1465,120,360,480,1
"859","5",19,"control",1333,320,220,540,1
"860","5",20,"control",1104,40,380,420,1
"861","5",21,"control",2438,380,60,440,1
"863","5",23,"control",1756,220,320,540,1
"864","5",24,"control",2405,380,20,400,0
"865","5",25,"control",1364,240,300,540,1
"866","5",26,"control",1123,280,280,560,1
"867","5",27,"control",1472,120,360,480,1
"868","5",28,"control",3491,360,160,520,0
"869","5",29,"control",1047,20,380,400,1
"870","5",30,"control",2013,340,180,520,1
"871","5",31,"control",2050,160,360,520,1
"872","5",32,"control",2576,380,20,400,1
"873","5",33,"control",2783,360,160,520,1
"874","5",34,"control",2749,360,120,480,0
"875","5",35,"control",1206,100,380,480,1
"876","5",36,"control",1194,40,380,420,1
"877","5",37,"multi-motive",2824,160,360,520,1
"878","5",38,"multi-motive",1753,220,320,540,1
"879","5",39,"multi-motive",3054,380,40,420,0
"880","5",40,"multi-motive",1047,100,380,480,1
"881","5",41,"multi-motive",2064,300,240,540,1
"882","5",42,"multi-motive",3351,380,60,440,0
"884","5",44,"multi-motive",2187,20,380,400,1
"885","5",45,"multi-motive",1090,60,380,440,1
"886","5",46,"control",2422,320,220,540,1
"887","5",47,"control",2089,360,120,480,1
"888","5",48,"control",1680,220,320,540,1
"889","5",49,"multi-motive",2722,340,180,520,1
"890","5",50,"multi-motive",1822,220,320,540,1
"891","5",51,"multi-motive",2654,380,20,400,0
"892","5",52,"multi-motive",869,40,380,420,1
"893","5",53,"multi-motive",1789,360,160,520,1
"894","5",54,"multi-motive",1305,180,340,520,1
"895","5",55,"control",2033,380,40,420,0
"896","5",56,"control",1491,300,240,540,1
"897","5",57,"control",1084,60,380,440,1
"898","5",58,"control",882,160,360,520,1
"899","5",59,"control",1349,100,380,480,1
"901","5",61,"control",2228,380,60,440,0
"902","5",62,"control",2089,380,100,480,1
"904","5",64,"control",1062,60,380,440,1
"905","5",65,"control",1609,180,340,520,1
"906","5",66,"control",1157,20,380,400,1
"907","5",67,"multi-motive",995,100,380,480,1
"909","5",69,"multi-motive",2168,360,120,480,1
"910","5",70,"multi-motive",1811,300,240,540,1
"911","5",71,"multi-motive",1078,120,360,480,1
"912","5",72,"multi-motive",2435,380,20,400,0
"913","5",73,"multi-motive",1534,160,360,520,1
"914","5",74,"multi-motive",2202,320,220,540,1
"915","5",75,"multi-motive",1653,240,300,540,1
"916","5",76,"multi-motive",1141,60,380,440,1
"917","5",77,"multi-motive",1532,40,380,420,1
"918","5",78,"multi-motive",2104,120,360,480,1
"920","5",80,"multi-motive",2542,380,100,480,1
"921","5",81,"multi-motive",1425,340,180,520,1
"922","5",82,"multi-motive",2636,380,60,440,0
"923","5",83,"multi-motive",3743,360,120,480,1
"924","5",84,"multi-motive",1485,380,100,480,1
"925","6",1,"multi-motive",2366,320,220,540,1
"926","6",2,"multi-motive",1609,20,380,400,1
"927","6",3,"multi-motive",1140,100,380,480,1
"928","6",4,"control",1719,380,40,420,0
"929","6",5,"control",2209,320,220,540,1
"930","6",6,"control",1497,360,120,480,0
"931","6",7,"multi-motive",2438,40,380,420,0
"932","6",8,"multi-motive",2121,380,100,480,0
"933","6",9,"multi-motive",2000,360,120,480,0
"934","6",10,"control",1512,100,380,480,1
"935","6",11,"control",1174,40,380,420,1
"936","6",12,"control",1913,380,20,400,0
"937","6",13,"control",1598,160,360,520,1
"938","6",14,"control",2062,340,180,520,0
"940","6",16,"multi-motive",1992,360,120,480,1
"941","6",17,"multi-motive",1885,380,40,420,0
"943","6",19,"multi-motive",1383,280,280,560,1
"944","6",20,"multi-motive",2001,380,20,400,0
"945","6",21,"multi-motive",1187,240,300,540,1
"946","6",22,"control",1708,320,220,540,1
"947","6",23,"control",2259,160,360,520,0
"948","6",24,"control",1397,60,380,440,1
"949","6",25,"control",1625,380,40,420,0
"952","6",28,"control",1336,380,60,440,0
"953","6",29,"control",2244,300,240,540,1
"954","6",30,"control",2411,380,100,480,0
"955","6",31,"control",1884,180,340,520,1
"956","6",32,"control",1805,380,100,480,0
"957","6",33,"control",2026,40,380,420,1
"958","6",34,"control",1691,380,60,440,0
"959","6",35,"control",1943,240,300,540,1
"960","6",36,"control",2363,280,280,560,1
"961","6",37,"control",2141,100,380,480,1
"962","6",38,"control",1820,220,320,540,1
"964","6",40,"control",1438,20,380,400,1
"965","6",41,"control",1058,20,380,400,1
"966","6",42,"control",1764,360,160,520,0
"967","6",43,"multi-motive",1217,120,360,480,1
"968","6",44,"multi-motive",2089,360,160,520,0
"970","6",46,"control",1447,120,360,480,1
"971","6",47,"control",1135,380,20,400,0
"972","6",48,"control",1903,180,340,520,1
"973","6",49,"multi-motive",1349,240,300,540,0
"974","6",50,"multi-motive",1432,380,100,480,0
"975","6",51,"multi-motive",1690,280,280,560,1
"976","6",52,"control",1797,60,380,440,1
"977","6",53,"control",1391,240,300,540,1
"978","6",54,"control",1795,340,180,520,0
"979","6",55,"multi-motive",1660,380,60,440,0
"980","6",56,"multi-motive",1223,160,360,520,1
"981","6",57,"multi-motive",1172,40,380,420,1
"982","6",58,"control",1395,280,280,560,1
"983","6",59,"control",2022,120,360,480,1
"984","6",60,"control",1568,360,160,520,0
"985","6",61,"control",1754,220,320,540,1
"986","6",62,"control",1506,300,240,540,0
"987","6",63,"control",1624,360,120,480,0
"988","6",64,"multi-motive",1563,180,340,520,1
"989","6",65,"multi-motive",2174,360,160,520,1
"990","6",66,"multi-motive",1700,220,320,540,1
"991","6",67,"multi-motive",1395,60,380,440,1
"992","6",68,"multi-motive",1778,120,360,480,1
"993","6",69,"multi-motive",2248,380,20,400,0
"994","6",70,"multi-motive",1350,180,340,520,1
"995","6",71,"multi-motive",883,20,380,400,1
"997","6",73,"multi-motive",2046,380,40,420,0
"998","6",74,"multi-motive",1378,300,240,540,1
"999","6",75,"multi-motive",2312,340,180,520,1
"1000","6",76,"multi-motive",1252,160,360,520,1
"1002","6",78,"multi-motive",1517,340,180,520,0
"1003","6",79,"multi-motive",1984,300,240,540,0
"1004","6",80,"multi-motive",2117,220,320,540,1
"1005","6",81,"multi-motive",1300,100,380,480,1
"1006","6",82,"multi-motive",1594,380,60,440,0
"1007","6",83,"multi-motive",2448,320,220,540,1
"1008","6",84,"multi-motive",1607,60,380,440,1
"1009","7",1,"empathy",2417,320,220,540,0
"1010","7",2,"empathy",3016,40,380,420,1
"1011","7",3,"empathy",2723,120,360,480,1
"1013","7",5,"empathy",2544,380,40,420,0
"1014","7",6,"empathy",3186,380,60,440,0
"1015","7",7,"empathy",2170,60,380,440,1
"1016","7",8,"empathy",1834,20,380,400,1
"1017","7",9,"empathy",1504,100,380,480,1
"1018","7",10,"reciprocity",1788,380,20,400,0
"1019","7",11,"reciprocity",1749,40,380,420,1
"1020","7",12,"reciprocity",2030,380,40,420,0
"1021","7",13,"empathy",2035,380,20,400,0
"1022","7",14,"empathy",2306,40,380,420,1
"1023","7",15,"empathy",1618,320,220,540,1
"1024","7",16,"empathy",2211,240,300,540,0
"1025","7",17,"empathy",1627,180,340,520,1
"1026","7",18,"empathy",1959,360,160,520,1
"1027","7",19,"reciprocity",2258,100,380,480,0
"1028","7",20,"reciprocity",1846,300,240,540,1
"1029","7",21,"reciprocity",1429,120,360,480,1
"1030","7",22,"empathy",1503,100,380,480,1
"1031","7",23,"empathy",1234,300,240,540,1
"1032","7",24,"empathy",2481,380,100,480,1
"1033","7",25,"empathy",1610,160,360,520,0
"1034","7",26,"empathy",2324,360,120,480,0
"1035","7",27,"empathy",1906,220,320,540,1
"1038","7",30,"reciprocity",1591,340,180,520,0
"1039","7",31,"reciprocity",2272,160,360,520,0
"1040","7",32,"reciprocity",1285,360,120,480,0
"1041","7",33,"reciprocity",1917,280,280,560,0
"1042","7",34,"reciprocity",1828,60,380,440,0
"1043","7",35,"reciprocity",1603,180,340,520,0
"1044","7",36,"reciprocity",2503,380,100,480,1
"1045","7",37,"reciprocity",2024,180,340,520,1
"1046","7",38,"reciprocity",1528,60,380,440,1
"1047","7",39,"reciprocity",2367,320,220,540,0
"1048","7",40,"empathy",2582,340,180,520,1
"1049","7",41,"empathy",1726,60,380,440,1
"1050","7",42,"empathy",1938,380,40,420,0
"1051","7",43,"empathy",2359,360,120,480,0
"1052","7",44,"empathy",2221,220,320,540,1
"1053","7",45,"empathy",1701,20,380,400,1
"1054","7",46,"reciprocity",2313,240,300,540,0
"1055","7",47,"reciprocity",2185,380,40,420,0
"1056","7",48,"reciprocity",2596,20,380,400,1
"1057","7",49,"reciprocity",2693,380,100,480,0
"1058","7",50,"reciprocity",2349,300,240,540,1
"1059","7",51,"reciprocity",1955,380,60,440,0
"1060","7",52,"empathy",2679,180,340,520,1
"1061","7",53,"empathy",2440,240,300,540,1
"1062","7",54,"empathy",2069,380,20,400,0
"1063","7",55,"reciprocity",2456,40,380,420,1
"1064","7",56,"reciprocity",2268,240,300,540,1
"1065","7",57,"reciprocity",2079,280,280,560,0
"1066","7",58,"reciprocity",2337,160,360,520,1
"1067","7",59,"reciprocity",1897,360,160,520,1
"1068","7",60,"reciprocity",2499,340,180,520,0
"1069","7",61,"reciprocity",1995,380,20,400,0
"1070","7",62,"reciprocity",2716,320,220,540,1
"1071","7",63,"reciprocity",2579,360,120,480,0
"1072","7",64,"empathy",2947,280,280,560,0
"1073","7",65,"empathy",1964,360,160,520,1
"1074","7",66,"empathy",2410,280,280,560,1
"1075","7",67,"empathy",2856,380,60,440,0
"1076","7",68,"empathy",2299,120,360,480,1
"1077","7",69,"empathy",3636,380,100,480,0
"1079","7",71,"empathy",2805,160,360,520,1
"1081","7",73,"reciprocity",2146,20,380,400,1
"1082","7",74,"reciprocity",1830,360,160,520,0
"1083","7",75,"reciprocity",2578,100,380,480,1
"1085","7",77,"reciprocity",1753,380,60,440,0
"1086","7",78,"reciprocity",2952,220,320,540,0
"1087","7",79,"reciprocity",2342,220,320,540,1
"1088","7",80,"reciprocity",2756,120,360,480,1
"1090","7",82,"empathy",2430,300,240,540,0
"1091","7",83,"empathy",2381,340,180,520,0
"1093","8",1,"reciprocity",1995,380,20,400,0
"1094","8",2,"reciprocity",1846,380,100,480,0
"1095","8",3,"reciprocity",1195,220,320,540,1
"1096","8",4,"empathy",1062,360,160,520,0
"1097","8",5,"empathy",1147,280,280,560,1
"1098","8",6,"empathy",1598,180,340,520,1
"1099","8",7,"empathy",1558,160,360,520,1
"1100","8",8,"empathy",1896,280,280,560,0
"1101","8",9,"empathy",1261,20,380,400,1
"1102","8",10,"reciprocity",1255,240,300,540,1
"1103","8",11,"reciprocity",1723,320,220,540,1
"1104","8",12,"reciprocity",1058,100,380,480,1
"1105","8",13,"reciprocity",2652,360,160,520,1
"1107","8",15,"reciprocity",1814,60,380,440,1
"1108","8",16,"empathy",1508,240,300,540,0
"1109","8",17,"empathy",1892,380,20,400,0
"1110","8",18,"empathy",2171,380,40,420,0
"1111","8",19,"empathy",1251,100,380,480,1
"1112","8",20,"empathy",1052,40,380,420,1
"1113","8",21,"empathy",1600,180,340,520,1
"1114","8",22,"empathy",1122,360,120,480,0
"1115","8",23,"empathy",1521,40,380,420,1
"1116","8",24,"empathy",1223,380,100,480,1
"1117","8",25,"reciprocity",1733,280,280,560,1
"1118","8",26,"reciprocity",755,380,40,420,0
"1119","8",27,"reciprocity",1503,340,180,520,0
"1120","8",28,"empathy",1121,360,160,520,0
"1123","8",31,"reciprocity",1507,40,380,420,1
"1124","8",32,"reciprocity",1415,360,120,480,1
"1125","8",33,"reciprocity",1492,180,340,520,1
"1126","8",34,"reciprocity",1705,180,340,520,0
"1127","8",35,"reciprocity",1031,380,20,400,0
"1128","8",36,"reciprocity",1299,360,120,480,0
"1129","8",37,"empathy",1272,220,320,540,0
"1130","8",38,"empathy",1344,120,360,480,1
"1131","8",39,"empathy",1346,380,60,440,0
"1132","8",40,"empathy",1468,20,380,400,1
"1133","8",41,"empathy",1102,160,360,520,1
"1134","8",42,"empathy",1544,120,360,480,1
"1135","8",43,"reciprocity",1830,380,60,440,0
"1136","8",44,"reciprocity",1280,240,300,540,0
"1137","8",45,"reciprocity",2004,340,180,520,0
"1138","8",46,"reciprocity",1299,20,380,400,1
"1139","8",47,"reciprocity",1908,320,220,540,0
"1140","8",48,"reciprocity",868,100,380,480,1
"1141","8",49,"reciprocity",2202,160,360,520,1
"1142","8",50,"reciprocity",1522,280,280,560,1
"1144","8",52,"empathy",1041,380,20,400,0
"1145","8",53,"empathy",2105,360,120,480,0
"1146","8",54,"empathy",1025,340,180,520,0
"1147","8",55,"reciprocity",941,120,360,480,1
"1149","8",57,"reciprocity",1481,380,100,480,0
"1150","8",58,"empathy",2031,240,300,540,1
"1151","8",59,"empathy",1518,60,380,440,0
"1152","8",60,"empathy",1067,380,60,440,0
"1153","8",61,"reciprocity",1858,120,360,480,1
"1154","8",62,"reciprocity",1713,380,40,420,0
"1155","8",63,"reciprocity",921,160,360,520,1
"1156","8",64,"reciprocity",1739,300,240,540,1
"1157","8",65,"reciprocity",1685,380,60,440,0
"1158","8",66,"reciprocity",1465,60,380,440,1
"1159","8",67,"empathy",1332,60,380,440,1
"1160","8",68,"empathy",1039,100,380,480,1
"1161","8",69,"empathy",799,300,240,540,0
"1162","8",70,"empathy",928,220,320,540,1
"1163","8",71,"empathy",1979,300,240,540,1
"1166","8",74,"reciprocity",2023,360,160,520,1
"1167","8",75,"reciprocity",1129,220,320,540,1
"1168","8",76,"empathy",1233,380,100,480,0
"1169","8",77,"empathy",919,320,220,540,0
"1170","8",78,"empathy",1941,320,220,540,1
"1171","8",79,"reciprocity",859,20,380,400,1
"1172","8",80,"reciprocity",926,40,380,420,1
"1173","8",81,"reciprocity",1197,300,240,540,0
"1175","8",83,"empathy",2249,340,180,520,0
"1176","8",84,"empathy",974,380,40,420,0
"1177","9",1,"empathy",2603,120,360,480,1
"1178","9",2,"empathy",3060,360,120,480,1
"1179","9",3,"empathy",3315,360,160,520,1
"1181","9",5,"empathy",2615,380,100,480,1
"1182","9",6,"empathy",1309,100,380,480,1
"1183","9",7,"reciprocity",2430,320,220,540,1
"1184","9",8,"reciprocity",1612,20,380,400,1
"1186","9",10,"reciprocity",2383,240,300,540,1
"1187","9",11,"reciprocity",3381,380,60,440,0
"1189","9",13,"reciprocity",2224,100,380,480,1
"1190","9",14,"reciprocity",3196,360,120,480,1
"1191","9",15,"reciprocity",3495,300,240,540,1
"1192","9",16,"empathy",2993,160,360,520,1
"1193","9",17,"empathy",2123,380,60,440,0
"1194","9",18,"empathy",1175,240,300,540,1
"1195","9",19,"empathy",1331,40,380,420,1
"1196","9",20,"empathy",1692,220,320,540,1
"1198","9",22,"empathy",3454,320,220,540,1
"1199","9",23,"empathy",2171,300,240,540,1
"1200","9",24,"empathy",2627,300,240,540,1
"1201","9",25,"empathy",2920,380,100,480,0
"1202","9",26,"empathy",3621,380,40,420,0
"1203","9",27,"empathy",889,160,360,520,1
"1204","9",28,"reciprocity",1420,360,160,520,1
"1205","9",29,"reciprocity",1448,160,360,520,1
"1206","9",30,"reciprocity",811,120,360,480,1
"1207","9",31,"reciprocity",1211,320,220,540,1
"1209","9",33,"reciprocity",918,180,340,520,1
"1210","9",34,"empathy",1436,40,380,420,1
"1211","9",35,"empathy",721,20,380,400,1
"1212","9",36,"empathy",3102,380,20,400,0
"1213","9",37,"empathy",1699,360,160,520,1
"1214","9",38,"empathy",974,280,280,560,1
"1215","9",39,"empathy",3380,340,180,520,1
"1216","9",40,"reciprocity",2906,380,20,400,0
"1217","9",41,"reciprocity",989,20,380,400,1
"1218","9",42,"reciprocity",1089,280,280,560,1
"1219","9",43,"empathy",888,100,380,480,1
"1220","9",44,"empathy",2150,120,360,480,1
"1221","9",45,"empathy",1067,20,380,400,1
"1222","9",46,"reciprocity",741,220,320,540,1
"1223","9",47,"reciprocity",2798,380,20,400,0
"1224","9",48,"reciprocity",1272,280,280,560,1
"1225","9",49,"empathy",815,60,380,440,1
"1226","9",50,"empathy",1200,180,340,520,1
"1227","9",51,"empathy",2509,360,120,480,1
"1229","9",53,"empathy",2257,220,320,540,1
"1230","9",54,"empathy",1125,60,380,440,1
"1231","9",55,"empathy",2048,340,180,520,1
"1232","9",56,"empathy",2291,380,40,420,0
"1234","9",58,"reciprocity",1369,160,360,520,1
"1235","9",59,"reciprocity",743,60,380,440,1
"1236","9",60,"reciprocity",985,120,360,480,1
"1237","9",61,"reciprocity",1081,40,380,420,1
"1238","9",62,"reciprocity",932,220,320,540,1
"1239","9",63,"reciprocity",880,100,380,480,1
"1240","9",64,"reciprocity",734,40,380,420,1
"1241","9",65,"reciprocity",907,240,300,540,1
"1242","9",66,"reciprocity",2087,380,100,480,1
"1243","9",67,"reciprocity",1198,180,340,520,1
"1244","9",68,"reciprocity",3109,380,60,440,0
"1245","9",69,"reciprocity",1567,380,100,480,1
"1246","9",70,"empathy",1393,180,340,520,1
"1248","9",72,"empathy",994,320,220,540,1
"1250","9",74,"reciprocity",1389,340,180,520,1
"1251","9",75,"reciprocity",2325,380,40,420,0
"1252","9",76,"reciprocity",781,360,160,520,1
"1253","9",77,"reciprocity",934,60,380,440,1
"1254","9",78,"reciprocity",2506,380,40,420,1
"1255","9",79,"reciprocity",1152,340,180,520,1
"1256","9",80,"reciprocity",1046,360,120,480,1
"1257","9",81,"reciprocity",814,300,240,540,1
"1258","9",82,"empathy",2029,380,20,400,0
"1259","9",83,"empathy",815,280,280,560,1
"1260","9",84,"empathy",1003,240,300,540,1
"1261","10",1,"empathy",2347,240,300,540,1
"1262","10",2,"empathy",2014,360,120,480,1
"1263","10",3,"empathy",2979,380,20,400,1
"1264","10",4,"empathy",2485,60,380,440,1
"1265","10",5,"empathy",2539,160,360,520,1
"1266","10",6,"empathy",2710,160,360,520,0
"1269","10",9,"empathy",2704,360,120,480,0
"1271","10",11,"reciprocity",1058,60,380,440,1
"1272","10",12,"reciprocity",2031,380,60,440,1
"1273","10",13,"empathy",2943,340,180,520,0
"1274","10",14,"empathy",1567,380,40,420,1
"1275","10",15,"empathy",1559,100,380,480,1
"1276","10",16,"empathy",2193,380,100,480,1
"1277","10",17,"empathy",1694,380,100,480,1
"1278","10",18,"empathy",1253,380,60,440,1
"1279","10",19,"reciprocity",1190,40,380,420,1
"1280","10",20,"reciprocity",1140,180,340,520,1
"1282","10",22,"reciprocity",1729,380,40,420,1
"1283","10",23,"reciprocity",1664,120,360,480,1
"1284","10",24,"reciprocity",2669,360,120,480,1
"1285","10",25,"empathy",3149,100,380,480,1
"1286","10",26,"empathy",2844,380,60,440,0
"1287","10",27,"empathy",1365,40,380,420,1
"1288","10",28,"empathy",1788,180,340,520,1
"1289","10",29,"empathy",2316,220,320,540,0
"1290","10",30,"empathy",2959,360,160,520,0
"1291","10",31,"reciprocity",1527,340,180,520,1
"1292","10",32,"reciprocity",1579,220,320,540,1
"1293","10",33,"reciprocity",1902,300,240,540,1
"1294","10",34,"empathy",1908,320,220,540,1
"1295","10",35,"empathy",2118,300,240,540,1
"1296","10",36,"empathy",2958,340,180,520,0
"1298","10",38,"empathy",1629,120,360,480,1
"1299","10",39,"empathy",2416,360,160,520,0
"1300","10",40,"reciprocity",2977,160,360,520,1
"1301","10",41,"reciprocity",1479,380,20,400,1
"1302","10",42,"reciprocity",1887,380,20,400,1
"1303","10",43,"reciprocity",1324,240,300,540,1
"1304","10",44,"reciprocity",1696,180,340,520,1
"1305","10",45,"reciprocity",1132,60,380,440,1
"1306","10",46,"reciprocity",1666,340,180,520,1
"1307","10",47,"reciprocity",1672,220,320,540,1
"1308","10",48,"reciprocity",1884,380,40,420,1
"1309","10",49,"reciprocity",1150,320,220,540,1
"1310","10",50,"reciprocity",1030,120,360,480,1
"1311","10",51,"reciprocity",1032,160,360,520,1
"1312","10",52,"reciprocity",1311,240,300,540,1
"1313","10",53,"reciprocity",1711,40,380,420,1
"1314","10",54,"reciprocity",1518,380,60,440,1
"1315","10",55,"reciprocity",2527,280,280,560,1
"1317","10",57,"reciprocity",2324,300,240,540,1
"1318","10",58,"reciprocity",1027,280,280,560,1
"1319","10",59,"reciprocity",1010,360,160,520,1
"1321","10",61,"empathy",1170,120,360,480,1
"1322","10",62,"empathy",1560,280,280,560,1
"1323","10",63,"empathy",1436,300,240,540,1
"1324","10",64,"reciprocity",1845,380,100,480,1
"1325","10",65,"reciprocity",1529,320,220,540,1
"1326","10",66,"reciprocity",1760,100,380,480,1
"1327","10",67,"empathy",1495,280,280,560,1
"1329","10",69,"empathy",1048,220,320,540,1
"1330","10",70,"empathy",2908,20,380,400,1
"1331","10",71,"empathy",1043,60,380,440,1
"1333","10",73,"reciprocity",1802,20,380,400,1
"1334","10",74,"reciprocity",904,100,380,480,1
"1335","10",75,"reciprocity",3003,360,160,520,0
"1336","10",76,"empathy",1931,40,380,420,1
"1337","10",77,"empathy",1140,20,380,400,1
"1338","10",78,"empathy",3531,380,20,400,0
"1339","10",79,"empathy",2903,380,40,420,0
"1340","10",80,"empathy",1544,180,340,520,1
"1341","10",81,"empathy",1973,320,220,540,1
"1342","10",82,"reciprocity",1589,380,100,480,1
"1343","10",83,"reciprocity",1970,360,120,480,0
"1344","10",84,"reciprocity",1820,20,380,400,1
"1346","11",2,"control",2075,380,40,420,0
"1347","11",3,"control",2020,380,40,420,0
"1348","11",4,"control",2550,20,380,400,0
"1349","11",5,"control",2513,220,320,540,1
"1350","11",6,"control",1673,180,340,520,1
"1351","11",7,"control",1733,100,380,480,1
"1352","11",8,"control",1874,380,60,440,0
"1353","11",9,"control",1595,100,380,480,0
"1354","11",10,"control",2607,380,20,400,1
"1355","11",11,"control",2107,280,280,560,1
"1356","11",12,"control",1411,40,380,420,1
"1358","11",14,"multi-motive",1505,360,160,520,1
"1359","11",15,"multi-motive",1206,380,20,400,0
"1360","11",16,"control",1759,60,380,440,1
"1361","11",17,"control",1609,160,360,520,0
"1362","11",18,"control",2331,60,380,440,0
"1363","11",19,"multi-motive",1839,300,240,540,0
"1364","11",20,"multi-motive",2397,380,60,440,0
"1365","11",21,"multi-motive",2501,300,240,540,0
"1366","11",22,"control",1829,180,340,520,1
"1367","11",23,"control",1499,220,320,540,1
"1368","11",24,"control",1590,120,360,480,1
"1369","11",25,"multi-motive",1924,220,320,540,1
"1370","11",26,"multi-motive",1477,120,360,480,1
"1371","11",27,"multi-motive",1422,240,300,540,0
"1372","11",28,"multi-motive",1479,20,380,400,1
"1373","11",29,"multi-motive",2336,40,380,420,1
"1374","11",30,"multi-motive",2308,60,380,440,1
"1375","11",31,"multi-motive",2424,360,120,480,0
"1376","11",32,"multi-motive",1808,180,340,520,1
"1378","11",34,"control",1466,380,20,400,0
"1379","11",35,"control",1667,300,240,540,0
"1380","11",36,"control",1701,340,180,520,0
"1381","11",37,"multi-motive",1457,280,280,560,0
"1382","11",38,"multi-motive",1524,380,100,480,0
"1383","11",39,"multi-motive",2382,20,380,400,1
"1384","11",40,"multi-motive",2485,120,360,480,1
"1385","11",41,"multi-motive",2396,100,380,480,1
"1386","11",42,"multi-motive",1671,40,380,420,1
"1387","11",43,"multi-motive",1768,320,220,540,1
"1389","11",45,"multi-motive",1816,240,300,540,1
"1390","11",46,"multi-motive",1744,160,360,520,1
"1391","11",47,"multi-motive",2432,360,160,520,0
"1392","11",48,"multi-motive",1797,320,220,540,0
"1393","11",49,"control",1344,380,100,480,0
"1394","11",50,"control",1922,160,360,520,1
"1396","11",52,"control",2693,40,380,420,0
"1397","11",53,"control",2072,300,240,540,1
"1398","11",54,"control",2189,360,160,520,0
"1401","11",57,"control",1714,20,380,400,1
"1402","11",58,"control",1763,120,360,480,0
"1403","11",59,"control",1252,340,180,520,0
"1404","11",60,"control",1731,360,120,480,0
"1405","11",61,"multi-motive",2400,340,180,520,0
"1407","11",63,"multi-motive",2342,380,100,480,1
"1408","11",64,"control",1836,320,220,540,0
"1409","11",65,"control",1098,360,160,520,0
"1410","11",66,"control",1657,240,300,540,1
"1411","11",67,"multi-motive",1916,380,40,420,0
"1412","11",68,"multi-motive",2174,180,340,520,0
"1413","11",69,"multi-motive",2295,340,180,520,0
"1414","11",70,"control",2705,280,280,560,1
"1415","11",71,"control",1619,380,100,480,0
"1416","11",72,"control",2072,320,220,540,1
"1417","11",73,"control",1253,360,120,480,0
"1418","11",74,"control",1333,240,300,540,0
"1419","11",75,"control",1563,380,60,440,0
"1420","11",76,"multi-motive",1641,160,360,520,1
"1421","11",77,"multi-motive",1310,60,380,440,1
"1422","11",78,"multi-motive",2009,280,280,560,1
"1423","11",79,"multi-motive",1165,380,40,420,0
"1424","11",80,"multi-motive",2079,360,120,480,0
"1425","11",81,"multi-motive",1751,380,20,400,0
"1426","11",82,"multi-motive",1613,380,60,440,0
"1427","11",83,"multi-motive",2127,220,320,540,0
"1428","11",84,"multi-motive",1378,100,380,480,1
"1597","12",1,"control",2757,100,380,480,1
"1598","12",2,"control",1479,120,360,480,1
"1599","12",3,"control",2762,360,160,520,0
"1600","12",4,"multi-motive",1824,380,40,420,0
"1601","12",5,"multi-motive",1752,340,180,520,1
"1602","12",6,"multi-motive",1833,60,380,440,1
"1603","12",7,"multi-motive",1585,220,320,540,1
"1604","12",8,"multi-motive",3231,60,380,440,0
"1605","12",9,"multi-motive",1474,300,240,540,0
"1606","12",10,"multi-motive",1121,360,160,520,1
"1607","12",11,"multi-motive",1950,360,120,480,0
"1608","12",12,"multi-motive",1183,120,360,480,1
"1609","12",13,"multi-motive",1062,40,380,420,1
"1610","12",14,"multi-motive",2896,160,360,520,0
"1611","12",15,"multi-motive",1492,340,180,520,0
"1612","12",16,"multi-motive",2706,240,300,540,1
"1613","12",17,"multi-motive",2065,300,240,540,1
"1614","12",18,"multi-motive",1372,280,280,560,0
"1616","12",20,"control",3535,380,20,400,1
"1617","12",21,"control",2674,60,380,440,1
"1618","12",22,"control",2681,380,60,440,1
"1619","12",23,"control",1290,20,380,400,1
"1620","12",24,"control",1538,40,380,420,1
"1622","12",26,"control",2235,300,240,540,0
"1623","12",27,"control",3324,380,100,480,1
"1624","12",28,"multi-motive",2314,40,380,420,0
"1626","12",30,"multi-motive",2395,380,100,480,1
"1627","12",31,"multi-motive",1552,360,160,520,0
"1628","12",32,"multi-motive",1713,20,380,400,1
"1629","12",33,"multi-motive",3919,360,120,480,1
"1630","12",34,"control",2242,220,320,540,0
"1631","12",35,"control",1236,240,300,540,1
"1633","12",37,"control",1236,220,320,540,1
"1634","12",38,"control",1296,100,380,480,0
"1635","12",39,"control",2950,380,40,420,0
"1636","12",40,"control",2317,40,380,420,0
"1637","12",41,"control",2548,320,220,540,1
"1638","12",42,"control",2306,320,220,540,0
"1639","12",43,"control",3048,300,240,540,1
"1640","12",44,"control",2134,380,100,480,0
"1641","12",45,"control",3108,240,300,540,0
"1642","12",46,"control",3926,120,360,480,0
"1644","12",48,"control",2875,160,360,520,1
"1645","12",49,"multi-motive",2306,320,220,540,0
"1646","12",50,"multi-motive",2471,180,340,520,1
"1647","12",51,"multi-motive",2188,320,220,540,1
"1648","12",52,"control",1967,340,180,520,0
"1649","12",53,"control",2267,180,340,520,0
"1650","12",54,"control",3611,20,380,400,1
"1652","12",56,"multi-motive",3761,380,20,400,0
"1653","12",57,"multi-motive",3348,280,280,560,1
"1655","12",59,"control",2817,360,120,480,0
"1656","12",60,"control",2986,280,280,560,0
"1657","12",61,"control",2979,340,180,520,1
"1658","12",62,"control",1895,360,160,520,1
"1659","12",63,"control",2799,60,380,440,1
"1660","12",64,"multi-motive",2751,180,340,520,0
"1661","12",65,"multi-motive",3683,380,60,440,1
"1662","12",66,"multi-motive",2761,380,100,480,1
"1663","12",67,"multi-motive",2320,100,380,480,1
"1664","12",68,"multi-motive",2566,380,60,440,0
"1665","12",69,"multi-motive",2899,120,360,480,0
"1666","12",70,"multi-motive",2099,160,360,520,1
"1667","12",71,"multi-motive",3666,20,380,400,1
"1669","12",73,"multi-motive",2305,240,300,540,1
"1670","12",74,"multi-motive",2129,220,320,540,0
"1679","12",83,"control",2410,280,280,560,1
"1680","12",84,"control",1942,180,340,520,1
"1681","13",1,"multi-motive",2261,100,380,480,1
"1682","13",2,"multi-motive",2085,160,360,520,1
"1683","13",3,"multi-motive",2925,380,60,440,1
"1684","13",4,"control",2167,300,240,540,1
"1685","13",5,"control",2511,380,40,420,1
"1686","13",6,"control",2849,240,300,540,1
"1687","13",7,"control",2828,20,380,400,1
"1688","13",8,"control",1792,40,380,420,1
"1689","13",9,"control",1823,180,340,520,1
"1690","13",10,"control",2508,300,240,540,1
"1691","13",11,"control",2528,360,160,520,1
"1692","13",12,"control",1750,40,380,420,1
"1694","13",14,"control",1473,100,380,480,1
"1695","13",15,"control",940,280,280,560,1
"1696","13",16,"control",1630,360,160,520,1
"1697","13",17,"control",2880,20,380,400,1
"1699","13",19,"control",2279,60,380,440,1
"1700","13",20,"control",1870,380,100,480,1
"1701","13",21,"control",3310,380,20,400,1
"1702","13",22,"multi-motive",3718,380,20,400,1
"1703","13",23,"multi-motive",2621,380,100,480,1
"1704","13",24,"multi-motive",2014,100,380,480,1
"1706","13",26,"multi-motive",1420,320,220,540,1
"1707","13",27,"multi-motive",1691,360,120,480,1
"1708","13",28,"control",1672,280,280,560,1
"1709","13",29,"control",1828,60,380,440,1
"1710","13",30,"control",1508,340,180,520,1
"1711","13",31,"multi-motive",1682,20,380,400,1
"1713","13",33,"multi-motive",3081,360,120,480,1
"1714","13",34,"multi-motive",1980,360,160,520,1
"1715","13",35,"multi-motive",1139,240,300,540,1
"1717","13",37,"multi-motive",1108,160,360,520,1
"1718","13",38,"multi-motive",1600,280,280,560,1
"1719","13",39,"multi-motive",1442,340,180,520,1
"1720","13",40,"control",1157,160,360,520,1
"1721","13",41,"control",2188,220,320,540,1
"1722","13",42,"control",1532,120,360,480,1
"1723","13",43,"multi-motive",2461,320,220,540,1
"1724","13",44,"multi-motive",2205,280,280,560,1
"1725","13",45,"multi-motive",1361,380,40,420,1
"1726","13",46,"control",1495,340,180,520,1
"1727","13",47,"control",1031,380,60,440,1
"1729","13",49,"multi-motive",1423,120,360,480,1
"1730","13",50,"multi-motive",1732,380,40,420,1
"1731","13",51,"multi-motive",1494,180,340,520,1
"1732","13",52,"multi-motive",2063,300,240,540,1
"1733","13",53,"multi-motive",1541,220,320,540,1
"1734","13",54,"multi-motive",2064,40,380,420,1
"1735","13",55,"multi-motive",2348,380,20,400,1
"1736","13",56,"multi-motive",1227,380,100,480,1
"1737","13",57,"multi-motive",1603,340,180,520,1
"1738","13",58,"control",1973,360,120,480,1
"1739","13",59,"control",1247,160,360,520,1
"1740","13",60,"control",1861,380,100,480,1
"1741","13",61,"control",1512,180,340,520,1
"1742","13",62,"control",1419,100,380,480,1
"1743","13",63,"control",1873,240,300,540,1
"1744","13",64,"control",1518,320,220,540,1
"1745","13",65,"control",1696,120,360,480,1
"1746","13",66,"control",2373,380,20,400,1
"1747","13",67,"multi-motive",2177,380,60,440,1
"1748","13",68,"multi-motive",1241,20,380,400,1
"1749","13",69,"multi-motive",1916,360,160,520,1
"1750","13",70,"multi-motive",1131,180,340,520,1
"1751","13",71,"multi-motive",1370,60,380,440,1
"1752","13",72,"multi-motive",1246,40,380,420,1
"1753","13",73,"multi-motive",946,300,240,540,1
"1755","13",75,"multi-motive",1274,220,320,540,1
"1756","13",76,"control",1227,320,220,540,1
"1757","13",77,"control",1094,360,120,480,1
"1758","13",78,"control",1660,380,60,440,1
"1759","13",79,"multi-motive",1054,60,380,440,1
"1760","13",80,"multi-motive",1731,120,360,480,1
"1761","13",81,"multi-motive",1499,240,300,540,1
"1762","13",82,"control",1399,220,320,540,1
"1763","13",83,"control",2516,380,40,420,1
"1765","14",1,"multi-motive",1786,40,380,420,1
"1766","14",2,"multi-motive",1891,240,300,540,1
"1767","14",3,"multi-motive",1634,300,240,540,1
"1768","14",4,"control",1468,40,380,420,1
"1769","14",5,"control",2069,380,100,480,1
"1770","14",6,"control",3245,360,160,520,1
"1771","14",7,"multi-motive",1547,380,100,480,1
"1772","14",8,"multi-motive",2290,180,340,520,1
"1773","14",9,"multi-motive",1888,180,340,520,1
"1774","14",10,"control",1689,360,160,520,1
"1775","14",11,"control",3665,380,20,400,1
"1776","14",12,"control",2878,380,100,480,1
"1777","14",13,"multi-motive",2939,360,120,480,1
"1778","14",14,"multi-motive",1240,160,360,520,1
"1779","14",15,"multi-motive",1219,120,360,480,1
"1780","14",16,"multi-motive",1223,220,320,540,1
"1781","14",17,"multi-motive",1615,360,120,480,1
"1782","14",18,"multi-motive",1308,380,20,400,1
"1783","14",19,"control",1349,300,240,540,1
"1784","14",20,"control",1057,120,360,480,1
"1785","14",21,"control",3375,380,20,400,1
"1786","14",22,"multi-motive",1372,360,160,520,1
"1787","14",23,"multi-motive",1903,100,380,480,1
"1788","14",24,"multi-motive",1572,380,40,420,1
"1789","14",25,"multi-motive",2605,280,280,560,1
"1791","14",27,"multi-motive",1656,40,380,420,1
"1792","14",28,"multi-motive",1994,380,60,440,1
"1793","14",29,"multi-motive",1795,380,40,420,1
"1795","14",31,"multi-motive",1656,340,180,520,1
"1796","14",32,"multi-motive",1973,120,360,480,1
"1797","14",33,"multi-motive",1842,20,380,400,1
"1798","14",34,"control",2623,340,180,520,1
"1799","14",35,"control",2717,360,120,480,0
"1801","14",37,"multi-motive",2698,360,160,520,1
"1802","14",38,"multi-motive",1939,280,280,560,1
"1803","14",39,"multi-motive",2754,380,60,440,1
"1804","14",40,"multi-motive",1726,160,360,520,1
"1805","14",41,"multi-motive",1481,380,100,480,1
"1806","14",42,"multi-motive",1363,320,220,540,1
"1807","14",43,"control",2905,240,300,540,1
"1808","14",44,"control",3211,160,360,520,1
"1810","14",46,"control",2698,40,380,420,1
"1811","14",47,"control",2197,220,320,540,1
"1812","14",48,"control",1401,100,380,480,1
"1813","14",49,"control",2038,100,380,480,1
"1815","14",51,"control",1601,60,380,440,1
"1816","14",52,"multi-motive",2506,380,20,400,1
"1817","14",53,"multi-motive",1364,300,240,540,1
"1818","14",54,"multi-motive",1174,320,220,540,1
"1819","14",55,"control",2092,380,60,440,1
"1820","14",56,"control",1381,220,320,540,1
"1821","14",57,"control",3433,380,60,440,1
"1822","14",58,"control",1270,20,380,400,1
"1823","14",59,"control",1217,180,340,520,1
"1825","14",61,"control",1362,300,240,540,1
"1826","14",62,"control",1676,280,280,560,1
"1827","14",63,"control",1929,360,120,480,1
"1828","14",64,"control",1911,20,380,400,1
"1830","14",66,"control",1547,280,280,560,1
"1831","14",67,"control",1677,60,380,440,1
"1832","14",68,"control",2155,380,40,420,1
"1833","14",69,"control",3088,340,180,520,1
"1834","14",70,"control",1439,320,220,540,1
"1835","14",71,"control",1419,160,360,520,1
"1836","14",72,"control",1473,240,300,540,1
"1837","14",73,"multi-motive",1579,220,320,540,1
"1838","14",74,"multi-motive",1713,60,380,440,1
"1839","14",75,"multi-motive",1205,100,380,480,1
"1840","14",76,"multi-motive",1118,60,380,440,1
"1841","14",77,"multi-motive",1710,20,380,400,1
"1842","14",78,"multi-motive",1521,340,180,520,1
"1843","14",79,"control",1568,380,40,420,1
"1844","14",80,"control",1350,320,220,540,1
"1845","14",81,"control",1405,180,340,520,1
"1846","14",82,"multi-motive",1396,240,300,540,1
"1849","15",1,"control",1847,180,340,520,1
"1850","15",2,"control",2276,380,40,420,0
"1851","15",3,"control",2518,380,100,480,1
"1852","15",4,"multi-motive",1381,40,380,420,1
"1853","15",5,"multi-motive",1907,220,320,540,1
"1855","15",7,"multi-motive",933,240,300,540,1
"1856","15",8,"multi-motive",1270,240,300,540,1
"1857","15",9,"multi-motive",1970,120,360,480,0
"1858","15",10,"control",1485,320,220,540,1
"1859","15",11,"control",1765,380,60,440,1
"1860","15",12,"control",1254,60,380,440,1
"1861","15",13,"multi-motive",1397,180,340,520,1
"1863","15",15,"multi-motive",1690,380,100,480,0
"1864","15",16,"control",1489,280,280,560,1
"1865","15",17,"control",1330,320,220,540,1
"1866","15",18,"control",1468,220,320,540,0
"1867","15",19,"control",2111,360,160,520,1
"1868","15",20,"control",1548,340,180,520,1
"1869","15",21,"control",1287,340,180,520,1
"1870","15",22,"multi-motive",2080,280,280,560,1
"1871","15",23,"multi-motive",1676,220,320,540,1
"1872","15",24,"multi-motive",1622,360,160,520,1
"1873","15",25,"control",2381,360,120,480,0
"1874","15",26,"control",1220,100,380,480,1
"1875","15",27,"control",1619,280,280,560,1
"1876","15",28,"control",1648,180,340,520,1
"1877","15",29,"control",946,240,300,540,1
"1878","15",30,"control",1708,40,380,420,1
"1880","15",32,"control",1024,40,380,420,1
"1881","15",33,"control",1735,20,380,400,1
"1882","15",34,"multi-motive",1587,120,360,480,1
"1883","15",35,"multi-motive",1780,380,100,480,0
"1884","15",36,"multi-motive",2556,340,180,520,1
"1885","15",37,"multi-motive",2149,340,180,520,0
"1886","15",38,"multi-motive",904,280,280,560,1
"1887","15",39,"multi-motive",2018,360,120,480,1
"1888","15",40,"multi-motive",1645,160,360,520,1
"1890","15",42,"multi-motive",902,20,380,400,1
"1891","15",43,"multi-motive",1018,60,380,440,1
"1892","15",44,"multi-motive",1665,40,380,420,1
"1893","15",45,"multi-motive",1963,380,20,400,0
"1894","15",46,"multi-motive",2238,300,240,540,1
"1895","15",47,"multi-motive",1902,380,60,440,1
"1896","15",48,"multi-motive",1982,380,60,440,0
"1897","15",49,"multi-motive",1599,320,220,540,1
"1898","15",50,"multi-motive",1607,180,340,520,1
"1899","15",51,"multi-motive",1302,60,380,440,1
"1900","15",52,"control",2189,380,100,480,1
"1902","15",54,"control",1884,160,360,520,1
"1904","15",56,"multi-motive",1368,380,40,420,0
"1905","15",57,"multi-motive",1386,20,380,400,1
"1906","15",58,"multi-motive",2130,380,20,400,0
"1907","15",59,"multi-motive",1131,360,160,520,1
"1909","15",61,"control",1412,380,20,400,1
"1910","15",62,"control",1368,120,360,480,1
"1911","15",63,"control",927,360,160,520,1
"1912","15",64,"control",1155,380,20,400,0
"1913","15",65,"control",1802,100,380,480,1
"1914","15",66,"control",1919,380,60,440,0
"1916","15",68,"control",1654,160,360,520,1
"1917","15",69,"control",1797,380,40,420,1
"1919","15",71,"control",1471,360,120,480,1
"1920","15",72,"control",1180,300,240,540,1
"1921","15",73,"control",913,120,360,480,1
"1922","15",74,"control",2179,60,380,440,1
"1923","15",75,"control",1833,240,300,540,1
"1924","15",76,"control",1514,220,320,540,1
"1925","15",77,"control",1296,20,380,400,1
"1926","15",78,"control",1124,300,240,540,1
"1927","15",79,"multi-motive",1073,160,360,520,1
"1928","15",80,"multi-motive",1732,380,40,420,1
"1929","15",81,"multi-motive",1428,320,220,540,1
"1930","15",82,"multi-motive",1295,100,380,480,1
"1931","15",83,"multi-motive",997,300,240,540,1
"1932","15",84,"multi-motive",825,100,380,480,1
"1933","16",1,"empathy",2602,380,60,440,1
"1934","16",2,"empathy",3673,300,240,540,0
"1935","16",3,"empathy",3124,360,160,520,1
"1936","16",4,"reciprocity",1915,20,380,400,1
"1937","16",5,"reciprocity",1645,40,380,420,1
"1938","16",6,"reciprocity",1661,280,280,560,1
"1939","16",7,"empathy",2029,340,180,520,1
"1940","16",8,"empathy",1871,380,40,420,1
"1941","16",9,"empathy",3107,20,380,400,0
"1942","16",10,"reciprocity",1910,380,40,420,1
"1943","16",11,"reciprocity",1214,20,380,400,1
"1944","16",12,"reciprocity",1629,360,120,480,1
"1945","16",13,"empathy",2471,320,220,540,1
"1946","16",14,"empathy",2829,240,300,540,1
"1947","16",15,"empathy",1443,20,380,400,1
"1949","16",17,"reciprocity",1615,360,160,520,1
"1950","16",18,"reciprocity",1510,380,100,480,1
"1951","16",19,"reciprocity",2452,300,240,540,1
"1952","16",20,"reciprocity",1285,60,380,440,1
"1953","16",21,"reciprocity",1628,340,180,520,1
"1954","16",22,"reciprocity",1661,360,160,520,1
"1955","16",23,"reciprocity",1842,240,300,540,1
"1956","16",24,"reciprocity",1472,180,340,520,1
"1957","16",25,"reciprocity",1785,380,100,480,1
"1958","16",26,"reciprocity",1571,320,220,540,1
"1959","16",27,"reciprocity",2100,380,20,400,1
"1960","16",28,"empathy",2009,360,120,480,1
"1961","16",29,"empathy",1853,100,380,480,1
"1962","16",30,"empathy",3595,380,100,480,1
"1963","16",31,"empathy",1926,380,60,440,1
"1965","16",33,"empathy",1657,320,220,540,1
"1967","16",35,"reciprocity",2337,120,360,480,1
"1968","16",36,"reciprocity",1534,100,380,480,1
"1969","16",37,"reciprocity",1766,40,380,420,1
"1970","16",38,"reciprocity",2233,240,300,540,1
"1971","16",39,"reciprocity",2141,180,340,520,1
"1972","16",40,"empathy",1638,40,380,420,1
"1973","16",41,"empathy",1887,380,20,400,1
"1974","16",42,"empathy",2789,180,340,520,1
"1975","16",43,"empathy",2802,360,120,480,0
"1976","16",44,"empathy",2500,40,380,420,1
"1978","16",46,"empathy",1680,120,360,480,1
"1979","16",47,"empathy",2609,60,380,440,1
"1980","16",48,"empathy",1565,160,360,520,1
"1981","16",49,"empathy",2677,380,20,400,0
"1982","16",50,"empathy",1752,300,240,540,1
"1984","16",52,"reciprocity",2645,220,320,540,1
"1986","16",54,"reciprocity",2555,60,380,440,1
"1987","16",55,"reciprocity",3880,380,60,440,1
"1988","16",56,"reciprocity",2380,280,280,560,1
"1989","16",57,"reciprocity",2934,320,220,540,1
"1990","16",58,"empathy",3106,380,40,420,0
"1991","16",59,"empathy",2273,180,340,520,1
"1992","16",60,"empathy",3159,220,320,540,0
"1993","16",61,"reciprocity",2416,340,180,520,1
"1994","16",62,"reciprocity",1750,300,240,540,1
"1996","16",64,"empathy",1981,280,280,560,1
"1997","16",65,"empathy",2578,280,280,560,0
"1998","16",66,"empathy",1798,220,320,540,1
"1999","16",67,"empathy",1852,60,380,440,1
"2000","16",68,"empathy",2769,340,180,520,0
"2002","16",70,"reciprocity",1813,380,60,440,1
"2003","16",71,"reciprocity",2043,360,120,480,1
"2004","16",72,"reciprocity",1364,120,360,480,1
"2005","16",73,"empathy",3013,100,380,480,0
"2006","16",74,"empathy",1469,240,300,540,1
"2007","16",75,"empathy",1626,360,160,520,1
"2008","16",76,"empathy",2620,120,360,480,0
"2009","16",77,"empathy",1652,380,100,480,1
"2010","16",78,"empathy",2744,160,360,520,0
"2011","16",79,"reciprocity",2025,220,320,540,1
"2012","16",80,"reciprocity",2103,160,360,520,1
"2013","16",81,"reciprocity",1604,380,20,400,1
"2014","16",82,"reciprocity",1685,160,360,520,1
"2015","16",83,"reciprocity",2106,100,380,480,1
"2016","16",84,"reciprocity",3064,380,40,420,0
"2017","17",1,"empathy",978,40,380,420,1
"2018","17",2,"empathy",1660,20,380,400,1
"2019","17",3,"empathy",1233,60,380,440,1
"2020","17",4,"empathy",1208,360,160,520,1
"2021","17",5,"empathy",1168,380,40,420,0
"2022","17",6,"empathy",1790,380,60,440,0
"2023","17",7,"reciprocity",1049,120,360,480,1
"2025","17",9,"reciprocity",906,220,320,540,1
"2027","17",11,"empathy",1416,220,320,540,1
"2029","17",13,"reciprocity",1077,380,60,440,0
"2031","17",15,"reciprocity",1074,20,380,400,1
"2032","17",16,"empathy",1424,360,120,480,0
"2033","17",17,"empathy",1403,380,60,440,0
"2034","17",18,"empathy",904,20,380,400,1
"2035","17",19,"reciprocity",683,300,240,540,1
"2036","17",20,"reciprocity",1051,380,20,400,0
"2037","17",21,"reciprocity",1188,340,180,520,1
"2038","17",22,"empathy",655,120,360,480,1
"2039","17",23,"empathy",1354,160,360,520,1
"2040","17",24,"empathy",798,100,380,480,1
"2042","17",26,"reciprocity",631,160,360,520,1
"2043","17",27,"reciprocity",610,100,380,480,1
"2045","17",29,"reciprocity",1014,360,120,480,0
"2046","17",30,"reciprocity",1205,320,220,540,1
"2047","17",31,"empathy",1801,240,300,540,1
"2048","17",32,"empathy",1300,60,380,440,1
"2049","17",33,"empathy",1185,120,360,480,1
"2050","17",34,"empathy",978,100,380,480,1
"2051","17",35,"empathy",1320,300,240,540,1
"2052","17",36,"empathy",945,360,160,520,0
"2053","17",37,"empathy",1508,340,180,520,1
"2054","17",38,"empathy",1467,380,100,480,0
"2055","17",39,"empathy",990,160,360,520,1
"2056","17",40,"empathy",1143,360,120,480,1
"2057","17",41,"empathy",975,380,20,400,0
"2058","17",42,"empathy",1577,180,340,520,0
"2059","17",43,"reciprocity",1558,380,100,480,0
"2060","17",44,"reciprocity",748,100,380,480,1
"2061","17",45,"reciprocity",1127,220,320,540,1
"2062","17",46,"reciprocity",1655,280,280,560,0
"2063","17",47,"reciprocity",896,60,380,440,1
"2064","17",48,"reciprocity",1171,120,360,480,1
"2065","17",49,"reciprocity",698,60,380,440,1
"2066","17",50,"reciprocity",638,160,360,520,1
"2067","17",51,"reciprocity",577,180,340,520,1
"2068","17",52,"empathy",1041,280,280,560,1
"2070","17",54,"empathy",1016,340,180,520,1
"2071","17",55,"reciprocity",1523,360,120,480,0
"2072","17",56,"reciprocity",1019,360,160,520,0
"2073","17",57,"reciprocity",712,380,20,400,0
"2074","17",58,"reciprocity",1070,300,240,540,0
"2075","17",59,"reciprocity",702,20,380,400,1
"2076","17",60,"reciprocity",795,360,160,520,1
"2077","17",61,"empathy",970,380,40,420,0
"2078","17",62,"empathy",1086,40,380,420,1
"2079","17",63,"empathy",979,380,20,400,0
"2080","17",64,"reciprocity",1028,380,40,420,0
"2081","17",65,"reciprocity",1295,240,300,540,1
"2082","17",66,"reciprocity",1566,380,100,480,0
"2083","17",67,"empathy",1200,280,280,560,0
"2085","17",69,"empathy",764,180,340,520,1
"2086","17",70,"reciprocity",1394,340,180,520,0
"2087","17",71,"reciprocity",664,240,300,540,1
"2088","17",72,"reciprocity",1220,320,220,540,0
"2089","17",73,"reciprocity",543,40,380,420,1
"2090","17",74,"reciprocity",920,280,280,560,1
"2091","17",75,"reciprocity",797,180,340,520,1
"2092","17",76,"reciprocity",972,380,60,440,0
"2093","17",77,"reciprocity",1487,40,380,420,1
"2094","17",78,"reciprocity",975,380,40,420,0
"2095","17",79,"empathy",1255,320,220,540,0
"2096","17",80,"empathy",1466,300,240,540,1
"2097","17",81,"empathy",1487,380,100,480,0
"2098","17",82,"empathy",989,320,220,540,0
"2099","17",83,"empathy",1547,220,320,540,1
"2100","17",84,"empathy",1100,240,300,540,1
"2101","18",1,"reciprocity",3287,380,100,480,1
"2102","18",2,"reciprocity",1165,160,360,520,1
"2103","18",3,"reciprocity",1810,360,120,480,1
"2104","18",4,"reciprocity",770,380,60,440,1
"2105","18",5,"reciprocity",773,180,340,520,0
"2106","18",6,"reciprocity",1481,120,360,480,1
"2107","18",7,"reciprocity",1434,380,20,400,1
"2108","18",8,"reciprocity",1852,380,40,420,0
"2109","18",9,"reciprocity",2566,340,180,520,0
"2111","18",11,"reciprocity",2965,220,320,540,1
"2112","18",12,"reciprocity",1557,240,300,540,1
"2113","18",13,"empathy",3793,380,60,440,0
"2115","18",15,"empathy",2120,40,380,420,0
"2116","18",16,"empathy",2219,300,240,540,1
"2117","18",17,"empathy",2605,280,280,560,1
"2118","18",18,"empathy",2419,360,120,480,0
"2119","18",19,"empathy",2546,320,220,540,1
"2120","18",20,"empathy",3434,340,180,520,1
"2122","18",22,"empathy",2520,100,380,480,1
"2123","18",23,"empathy",3479,380,40,420,0
"2124","18",24,"empathy",3040,100,380,480,1
"2125","18",25,"empathy",1136,40,380,420,1
"2128","18",28,"reciprocity",1875,40,380,420,1
"2129","18",29,"reciprocity",1684,340,180,520,1
"2131","18",31,"reciprocity",1897,360,120,480,1
"2132","18",32,"reciprocity",2813,380,100,480,0
"2133","18",33,"reciprocity",1383,100,380,480,1
"2134","18",34,"empathy",2579,120,360,480,1
"2135","18",35,"empathy",2628,380,20,400,1
"2136","18",36,"empathy",2630,160,360,520,1
"2137","18",37,"empathy",1738,380,40,420,1
"2138","18",38,"empathy",2808,20,380,400,1
"2139","18",39,"empathy",2024,380,20,400,0
"2140","18",40,"empathy",1350,240,300,540,1
"2141","18",41,"empathy",1437,320,220,540,1
"2142","18",42,"empathy",1089,380,60,440,0
"2143","18",43,"empathy",2146,380,100,480,1
"2144","18",44,"empathy",1677,60,380,440,0
"2146","18",46,"empathy",1449,220,320,540,1
"2147","18",47,"empathy",2482,60,380,440,1
"2148","18",48,"empathy",2607,240,300,540,1
"2149","18",49,"empathy",1169,340,180,520,1
"2150","18",50,"empathy",2241,360,160,520,1
"2151","18",51,"empathy",1735,360,120,480,1
"2152","18",52,"reciprocity",1090,280,280,560,1
"2153","18",53,"reciprocity",901,20,380,400,1
"2154","18",54,"reciprocity",1100,120,360,480,1
"2155","18",55,"empathy",1144,180,340,520,1
"2156","18",56,"empathy",966,160,360,520,1
"2157","18",57,"empathy",963,280,280,560,1
"2158","18",58,"reciprocity",881,380,60,440,0
"2159","18",59,"reciprocity",1662,380,20,400,1
"2160","18",60,"reciprocity",3186,380,40,420,0
"2161","18",61,"reciprocity",1989,240,300,540,1
"2162","18",62,"reciprocity",1014,320,220,540,0
"2163","18",63,"reciprocity",1243,280,280,560,1
"2166","18",66,"reciprocity",3696,300,240,540,0
"2167","18",67,"reciprocity",844,20,380,400,1
"2168","18",68,"reciprocity",795,360,160,520,0
"2169","18",69,"reciprocity",1106,40,380,420,1
"2170","18",70,"empathy",980,380,100,480,1
"2171","18",71,"empathy",907,300,240,540,1
"2172","18",72,"empathy",893,120,360,480,1
"2173","18",73,"reciprocity",2165,300,240,540,1
"2174","18",74,"reciprocity",1752,220,320,540,1
"2175","18",75,"reciprocity",849,180,340,520,1
"2176","18",76,"reciprocity",903,60,380,440,1
"2177","18",77,"reciprocity",656,100,380,480,1
"2178","18",78,"reciprocity",1417,160,360,520,1
"2179","18",79,"empathy",700,20,380,400,1
"2180","18",80,"empathy",974,360,160,520,1
"2181","18",81,"empathy",2377,180,340,520,1
"2182","18",82,"reciprocity",1150,60,380,440,1
"2183","18",83,"reciprocity",1328,360,160,520,1
"2184","18",84,"reciprocity",1950,320,220,540,1
"2185","19",1,"control",1930,120,360,480,1
"2186","19",2,"control",1408,380,60,440,0
"2187","19",3,"control",1181,60,380,440,1
"2188","19",4,"control",2478,320,220,540,1
"2189","19",5,"control",2336,60,380,440,1
"2190","19",6,"control",2004,300,240,540,1
"2191","19",7,"multi-motive",2746,380,40,420,1
"2192","19",8,"multi-motive",2713,380,60,440,0
"2194","19",10,"control",2749,380,100,480,0
"2195","19",11,"control",1927,360,160,520,1
"2197","19",13,"control",3568,320,220,540,1
"2199","19",15,"control",1447,280,280,560,1
"2201","19",17,"control",2424,280,280,560,0
"2202","19",18,"control",2657,20,380,400,1
"2203","19",19,"control",3036,40,380,420,0
"2205","19",21,"control",1796,380,100,480,1
"2206","19",22,"control",1303,360,120,480,0
"2207","19",23,"control",2042,180,340,520,1
"2208","19",24,"control",1704,360,160,520,0
"2209","19",25,"control",2976,360,120,480,1
"2210","19",26,"control",2634,240,300,540,0
"2211","19",27,"control",1282,380,60,440,0
"2212","19",28,"multi-motive",3029,280,280,560,1
"2214","19",30,"multi-motive",1753,360,120,480,1
"2215","19",31,"multi-motive",2840,380,20,400,0
"2217","19",33,"multi-motive",2583,360,120,480,0
"2218","19",34,"control",2015,160,360,520,1
"2219","19",35,"control",1677,340,180,520,0
"2221","19",37,"multi-motive",2109,340,180,520,0
"2222","19",38,"multi-motive",2379,240,300,540,0
"2223","19",39,"multi-motive",2099,380,40,420,0
"2224","19",40,"control",1106,40,380,420,1
"2225","19",41,"control",2386,340,180,520,1
"2226","19",42,"control",2553,380,40,420,0
"2227","19",43,"multi-motive",2376,280,280,560,1
"2228","19",44,"multi-motive",2746,160,360,520,1
"2230","19",46,"multi-motive",1535,380,100,480,0
"2231","19",47,"multi-motive",1863,360,160,520,1
"2233","19",49,"multi-motive",1171,20,380,400,1
"2234","19",50,"multi-motive",1434,100,380,480,1
"2235","19",51,"multi-motive",3140,160,360,520,0
"2236","19",52,"multi-motive",1946,300,240,540,1
"2237","19",53,"multi-motive",2314,60,380,440,1
"2241","19",57,"control",973,20,380,400,1
"2242","19",58,"multi-motive",1836,60,380,440,1
"2243","19",59,"multi-motive",2061,120,360,480,1
"2244","19",60,"multi-motive",1657,240,300,540,1
"2245","19",61,"multi-motive",2812,320,220,540,0
"2246","19",62,"multi-motive",1307,380,60,440,0
"2247","19",63,"multi-motive",3590,340,180,520,0
"2248","19",64,"control",1387,160,360,520,1
"2249","19",65,"control",1823,380,40,420,0
"2250","19",66,"control",3728,300,240,540,0
"2251","19",67,"multi-motive",2106,180,340,520,1
"2252","19",68,"multi-motive",2643,120,360,480,1
"2253","19",69,"multi-motive",642,220,320,540,0
"2254","19",70,"multi-motive",1236,180,340,520,1
"2255","19",71,"multi-motive",1042,40,380,420,1
"2256","19",72,"multi-motive",2568,40,380,420,1
"2257","19",73,"control",2143,180,340,520,1
"2258","19",74,"control",3257,120,360,480,1
"2259","19",75,"control",2648,380,20,400,0
"2260","19",76,"multi-motive",2327,360,160,520,0
"2261","19",77,"multi-motive",2157,20,380,400,1
"2262","19",78,"multi-motive",1331,380,20,400,0
"2263","19",79,"multi-motive",1830,100,380,480,1
"2264","19",80,"multi-motive",2965,300,240,540,0
"2266","19",82,"control",3344,100,380,480,1
"2267","19",83,"control",2722,380,20,400,0
"2268","19",84,"control",2369,100,380,480,1
"2269","20",1,"control",3799,300,240,540,0
"2270","20",2,"control",2487,40,380,420,0
"2271","20",3,"control",2065,180,340,520,0
"2272","20",4,"multi-motive",2803,340,180,520,0
"2273","20",5,"multi-motive",2367,380,60,440,1
"2274","20",6,"multi-motive",2735,280,280,560,0
"2275","20",7,"control",3260,380,20,400,1
"2276","20",8,"control",2530,120,360,480,0
"2277","20",9,"control",1928,320,220,540,1
"2278","20",10,"multi-motive",1372,300,240,540,1
"2279","20",11,"multi-motive",1102,280,280,560,1
"2280","20",12,"multi-motive",1714,60,380,440,0
"2281","20",13,"multi-motive",3005,300,240,540,0
"2282","20",14,"multi-motive",1233,180,340,520,1
"2283","20",15,"multi-motive",2909,40,380,420,0
"2284","20",16,"control",2470,360,160,520,1
"2285","20",17,"control",3560,20,380,400,0
"2286","20",18,"control",1394,120,360,480,1
"2287","20",19,"control",1802,160,360,520,0
"2288","20",20,"control",1999,360,120,480,1
"2289","20",21,"control",2533,360,160,520,1
"2290","20",22,"control",1767,340,180,520,1
"2291","20",23,"control",3532,240,300,540,0
"2293","20",25,"multi-motive",3797,160,360,520,0
"2294","20",26,"multi-motive",3983,360,160,520,1
"2295","20",27,"multi-motive",1440,60,380,440,1
"2296","20",28,"multi-motive",1611,160,360,520,1
"2297","20",29,"multi-motive",2810,220,320,540,0
"2298","20",30,"multi-motive",2179,340,180,520,1
"2299","20",31,"multi-motive",1978,180,340,520,0
"2301","20",33,"multi-motive",1337,360,120,480,1
"2302","20",34,"multi-motive",2416,380,20,400,0
"2303","20",35,"multi-motive",1400,360,160,520,0
"2304","20",36,"multi-motive",2010,380,40,420,1
"2305","20",37,"multi-motive",2150,100,380,480,1
"2306","20",38,"multi-motive",1317,120,360,480,1
"2308","20",40,"control",2854,380,100,480,0
"2309","20",41,"control",1585,240,300,540,1
"2310","20",42,"control",1584,160,360,520,1
"2311","20",43,"control",1938,380,20,400,0
"2315","20",47,"multi-motive",1612,240,300,540,1
"2316","20",48,"multi-motive",1009,20,380,400,1
"2317","20",49,"control",1933,380,60,440,0
"2319","20",51,"control",3816,380,40,420,0
"2320","20",52,"control",1449,20,380,400,1
"2321","20",53,"control",3849,100,380,480,0
"2322","20",54,"control",3491,320,220,540,0
"2323","20",55,"control",2348,220,320,540,1
"2324","20",56,"control",2201,300,240,540,0
"2326","20",58,"multi-motive",2974,380,20,400,1
"2327","20",59,"multi-motive",2987,20,380,400,0
"2328","20",60,"multi-motive",1582,380,100,480,0
"2329","20",61,"multi-motive",1991,220,320,540,1
"2330","20",62,"multi-motive",2172,380,40,420,0
"2331","20",63,"multi-motive",2530,380,60,440,1
"2332","20",64,"multi-motive",3430,240,300,540,0
"2333","20",65,"multi-motive",1358,320,220,540,0
"2334","20",66,"multi-motive",3265,320,220,540,1
"2335","20",67,"multi-motive",2826,380,100,480,1
"2336","20",68,"multi-motive",1800,40,380,420,1
"2337","20",69,"multi-motive",1473,100,380,480,0
"2338","20",70,"control",2502,280,280,560,1
"2339","20",71,"control",3102,380,40,420,1
"2340","20",72,"control",3118,60,380,440,1
"2341","20",73,"control",2795,60,380,440,1
"2342","20",74,"control",2384,360,120,480,0
"2343","20",75,"control",1801,100,380,480,1
"2344","20",76,"control",2191,280,280,560,0
"2345","20",77,"control",1418,180,340,520,1
"2346","20",78,"control",1473,40,380,420,1
"2347","20",79,"control",2314,380,100,480,1
"2349","20",81,"control",2483,340,180,520,0
"2351","20",83,"multi-motive",2291,120,360,480,0
"2437","21",1,"control",2633,360,160,520,1
"2438","21",2,"control",3108,220,320,540,1
"2439","21",3,"control",1561,280,280,560,1
"2440","21",4,"control",1619,180,340,520,1
"2441","21",5,"control",1236,120,360,480,1
"2442","21",6,"control",2733,380,20,400,0
"2443","21",7,"control",1908,180,340,520,1
"2444","21",8,"control",1591,100,380,480,1
"2445","21",9,"control",2025,380,40,420,0
"2446","21",10,"control",2074,160,360,520,1
"2447","21",11,"control",1601,40,380,420,1
"2448","21",12,"control",1494,40,380,420,1
"2449","21",13,"multi-motive",1475,120,360,480,1
"2450","21",14,"multi-motive",2272,380,20,400,0
"2451","21",15,"multi-motive",1888,60,380,440,1
"2452","21",16,"multi-motive",1419,240,300,540,1
"2453","21",17,"multi-motive",1529,120,360,480,1
"2454","21",18,"multi-motive",2829,360,160,520,0
"2455","21",19,"multi-motive",1357,220,320,540,1
"2456","21",20,"multi-motive",1360,40,380,420,1
"2457","21",21,"multi-motive",1672,160,360,520,1
"2458","21",22,"multi-motive",1948,380,40,420,0
"2459","21",23,"multi-motive",1636,280,280,560,1
"2460","21",24,"multi-motive",1573,380,100,480,1
"2461","21",25,"control",2112,60,380,440,1
"2463","21",27,"control",1355,100,380,480,1
"2464","21",28,"control",2252,380,40,420,1
"2465","21",29,"control",1593,240,300,540,1
"2466","21",30,"control",3061,320,220,540,0
"2467","21",31,"control",1721,160,360,520,1
"2468","21",32,"control",1493,20,380,400,1
"2469","21",33,"control",1855,340,180,520,1
"2470","21",34,"control",2623,380,60,440,1
"2471","21",35,"control",2726,380,60,440,0
"2473","21",37,"multi-motive",1716,280,280,560,1
"2474","21",38,"multi-motive",2333,380,60,440,0
"2475","21",39,"multi-motive",1647,220,320,540,1
"2476","21",40,"control",1981,360,120,480,1
"2477","21",41,"control",2079,380,20,400,0
"2478","21",42,"control",1811,300,240,540,1
"2479","21",43,"multi-motive",2346,380,60,440,1
"2480","21",44,"multi-motive",1629,240,300,540,1
"2481","21",45,"multi-motive",1525,20,380,400,1
"2482","21",46,"multi-motive",2371,380,100,480,1
"2484","21",48,"multi-motive",2577,320,220,540,1
"2485","21",49,"multi-motive",1814,160,360,520,1
"2486","21",50,"multi-motive",1314,180,340,520,1
"2487","21",51,"multi-motive",2555,360,120,480,1
"2488","21",52,"multi-motive",1623,300,240,540,1
"2489","21",53,"multi-motive",2082,360,160,520,0
"2490","21",54,"multi-motive",1216,100,380,480,1
"2491","21",55,"multi-motive",1921,380,40,420,1
"2492","21",56,"multi-motive",1294,180,340,520,1
"2493","21",57,"multi-motive",1333,40,380,420,1
"2495","21",59,"control",1610,340,180,520,1
"2497","21",61,"multi-motive",1355,320,220,540,1
"2498","21",62,"multi-motive",1602,20,380,400,1
"2499","21",63,"multi-motive",1303,300,240,540,1
"2500","21",64,"multi-motive",2304,360,120,480,1
"2503","21",67,"control",1070,60,380,440,1
"2504","21",68,"control",1222,20,380,400,1
"2505","21",69,"control",1509,120,360,480,1
"2506","21",70,"multi-motive",1494,100,380,480,1
"2507","21",71,"multi-motive",2203,380,20,400,0
"2508","21",72,"multi-motive",1481,340,180,520,1
"2509","21",73,"control",1483,240,300,540,1
"2510","21",74,"control",1077,220,320,540,1
"2511","21",75,"control",1629,360,120,480,1
"2512","21",76,"control",1411,320,220,540,1
"2513","21",77,"control",1441,380,100,480,1
"2514","21",78,"control",1519,380,100,480,0
"2515","21",79,"multi-motive",977,60,380,440,1
"2517","21",81,"multi-motive",1988,340,180,520,0
"2519","21",83,"control",1672,300,240,540,1
"2520","21",84,"control",1224,280,280,560,1
"2521","22",1,"reciprocity",2460,380,20,400,0
"2522","22",2,"reciprocity",2213,20,380,400,1
"2523","22",3,"reciprocity",2311,380,20,400,1
"2524","22",4,"reciprocity",3925,360,120,480,0
"2525","22",5,"reciprocity",3497,380,100,480,1
"2526","22",6,"reciprocity",3100,300,240,540,0
"2528","22",8,"empathy",3233,380,40,420,1
"2529","22",9,"empathy",1567,100,380,480,1
"2530","22",10,"empathy",1861,120,360,480,1
"2531","22",11,"empathy",2332,360,160,520,1
"2532","22",12,"empathy",2236,380,60,440,1
"2533","22",13,"empathy",1390,280,280,560,1
"2534","22",14,"empathy",2805,300,240,540,1
"2535","22",15,"empathy",1540,240,300,540,1
"2536","22",16,"reciprocity",3796,360,160,520,1
"2537","22",17,"reciprocity",3157,280,280,560,0
"2538","22",18,"reciprocity",2825,160,360,520,1
"2539","22",19,"empathy",2883,160,360,520,1
"2540","22",20,"empathy",2756,380,100,480,1
"2541","22",21,"empathy",2173,40,380,420,1
"2542","22",22,"reciprocity",1982,360,120,480,1
"2543","22",23,"reciprocity",2197,120,360,480,1
"2544","22",24,"reciprocity",2348,220,320,540,1
"2545","22",25,"reciprocity",1872,380,60,440,1
"2546","22",26,"reciprocity",1937,320,220,540,1
"2547","22",27,"reciprocity",2470,60,380,440,1
"2548","22",28,"empathy",2124,20,380,400,1
"2549","22",29,"empathy",2062,380,20,400,1
"2551","22",31,"reciprocity",1943,160,360,520,1
"2552","22",32,"reciprocity",1995,280,280,560,1
"2553","22",33,"reciprocity",2408,60,380,440,1
"2554","22",34,"empathy",2781,320,220,540,1
"2556","22",36,"empathy",2228,240,300,540,1
"2558","22",38,"reciprocity",1943,180,340,520,1
"2559","22",39,"reciprocity",2671,300,240,540,1
"2560","22",40,"reciprocity",2542,380,60,440,1
"2561","22",41,"reciprocity",1809,380,40,420,0
"2562","22",42,"reciprocity",2347,240,300,540,1
"2563","22",43,"reciprocity",1292,40,380,420,1
"2564","22",44,"reciprocity",1496,100,380,480,1
"2566","22",46,"reciprocity",2283,340,180,520,1
"2567","22",47,"reciprocity",3825,360,160,520,1
"2568","22",48,"reciprocity",2288,320,220,540,1
"2569","22",49,"reciprocity",2020,100,380,480,1
"2570","22",50,"reciprocity",2232,180,340,520,1
"2571","22",51,"reciprocity",3018,120,360,480,1
"2573","22",53,"empathy",3229,60,380,440,1
"2574","22",54,"empathy",1574,320,220,540,1
"2575","22",55,"empathy",3041,100,380,480,1
"2576","22",56,"empathy",2226,180,340,520,1
"2577","22",57,"empathy",2084,360,120,480,1
"2578","22",58,"empathy",2157,220,320,540,1
"2580","22",60,"empathy",1587,60,380,440,1
"2582","22",62,"reciprocity",1851,380,100,480,1
"2583","22",63,"reciprocity",2216,240,300,540,1
"2584","22",64,"empathy",2631,380,20,400,1
"2585","22",65,"empathy",2210,220,320,540,1
"2586","22",66,"empathy",2185,40,380,420,1
"2588","22",68,"reciprocity",3160,220,320,540,1
"2589","22",69,"reciprocity",1645,40,380,420,1
"2591","22",71,"reciprocity",1874,340,180,520,1
"2592","22",72,"reciprocity",1514,20,380,400,1
"2593","22",73,"empathy",2351,120,360,480,1
"2594","22",74,"empathy",3128,180,340,520,1
"2595","22",75,"empathy",3319,380,40,420,0
"2596","22",76,"empathy",2987,280,280,560,1
"2598","22",78,"empathy",1555,20,380,400,1
"2599","22",79,"empathy",1738,360,160,520,1
"2600","22",80,"empathy",2269,380,100,480,1
"2602","22",82,"empathy",2796,340,180,520,1
"2603","22",83,"empathy",1672,300,240,540,1
"2604","22",84,"empathy",2987,160,360,520,1
"2605","23",1,"empathy",1373,320,220,540,1
"2606","23",2,"empathy",1249,100,380,480,1
"2608","23",4,"empathy",1009,160,360,520,1
"2609","23",5,"empathy",889,300,240,540,0
"2610","23",6,"empathy",902,220,320,540,1
"2611","23",7,"reciprocity",899,300,240,540,1
"2612","23",8,"reciprocity",1031,360,120,480,1
"2613","23",9,"reciprocity",1287,340,180,520,0
"2614","23",10,"reciprocity",1224,280,280,560,1
"2615","23",11,"reciprocity",1841,60,380,440,0
"2616","23",12,"reciprocity",1151,20,380,400,1
"2617","23",13,"reciprocity",1505,180,340,520,1
"2618","23",14,"reciprocity",856,160,360,520,1
"2619","23",15,"reciprocity",1193,340,180,520,1
"2620","23",16,"reciprocity",1199,100,380,480,0
"2621","23",17,"reciprocity",1392,380,100,480,1
"2622","23",18,"reciprocity",886,380,60,440,1
"2623","23",19,"reciprocity",1186,360,160,520,1
"2624","23",20,"reciprocity",1110,240,300,540,1
"2625","23",21,"reciprocity",972,60,380,440,1
"2626","23",22,"empathy",781,20,380,400,1
"2627","23",23,"empathy",780,280,280,560,1
"2628","23",24,"empathy",977,60,380,440,1
"2629","23",25,"reciprocity",742,220,320,540,1
"2630","23",26,"reciprocity",1081,40,380,420,1
"2631","23",27,"reciprocity",1674,380,20,400,0
"2632","23",28,"empathy",1783,380,100,480,1
"2634","23",30,"empathy",1141,340,180,520,1
"2635","23",31,"empathy",1006,180,340,520,1
"2636","23",32,"empathy",780,320,220,540,1
"2637","23",33,"empathy",934,40,380,420,1
"2638","23",34,"empathy",1176,100,380,480,1
"2639","23",35,"empathy",867,380,40,420,1
"2640","23",36,"empathy",1723,180,340,520,0
"2641","23",37,"empathy",1149,340,180,520,1
"2644","23",40,"reciprocity",1186,300,240,540,1
"2645","23",41,"reciprocity",816,120,360,480,1
"2646","23",42,"reciprocity",1564,220,320,540,0
"2647","23",43,"empathy",1891,220,320,540,1
"2648","23",44,"empathy",1347,380,40,420,1
"2649","23",45,"empathy",1015,360,120,480,1
"2650","23",46,"empathy",1255,240,300,540,1
"2651","23",47,"empathy",1207,380,20,400,1
"2652","23",48,"empathy",1722,20,380,400,1
"2653","23",49,"empathy",756,240,300,540,1
"2654","23",50,"empathy",1809,380,60,440,0
"2655","23",51,"empathy",776,380,20,400,1
"2657","23",53,"reciprocity",1670,380,100,480,0
"2658","23",54,"reciprocity",1722,320,220,540,1
"2659","23",55,"reciprocity",1709,380,60,440,1
"2660","23",56,"reciprocity",1015,160,360,520,1
"2661","23",57,"reciprocity",1058,360,120,480,1
"2662","23",58,"empathy",1129,380,100,480,1
"2663","23",59,"empathy",1695,300,240,540,1
"2664","23",60,"empathy",1482,60,380,440,1
"2665","23",61,"reciprocity",2273,360,160,520,0
"2666","23",62,"reciprocity",1339,120,360,480,1
"2667","23",63,"reciprocity",1087,380,40,420,1
"2668","23",64,"reciprocity",831,100,380,480,1
"2669","23",65,"reciprocity",1259,380,40,420,1
"2673","23",69,"reciprocity",1034,180,340,520,1
"2674","23",70,"reciprocity",1907,380,20,400,1
"2675","23",71,"reciprocity",874,280,280,560,1
"2676","23",72,"reciprocity",1111,240,300,540,0
"2677","23",73,"empathy",796,360,160,520,1
"2678","23",74,"empathy",1757,280,280,560,1
"2679","23",75,"empathy",941,160,360,520,1
"2680","23",76,"reciprocity",1235,320,220,540,0
"2681","23",77,"reciprocity",1392,40,380,420,1
"2682","23",78,"reciprocity",1368,20,380,400,1
"2683","23",79,"empathy",1137,360,120,480,1
"2684","23",80,"empathy",1092,360,160,520,1
"2685","23",81,"empathy",1375,120,360,480,1
"2686","23",82,"empathy",1088,380,60,440,1
"2687","23",83,"empathy",552,120,360,480,1
"2688","23",84,"empathy",1072,40,380,420,1
"2689","24",1,"reciprocity",2119,360,120,480,1
"2690","24",2,"reciprocity",1978,180,340,520,1
"2691","24",3,"reciprocity",1974,340,180,520,0
"2692","24",4,"empathy",1711,240,300,540,1
"2693","24",5,"empathy",2593,300,240,540,1
"2694","24",6,"empathy",1682,240,300,540,1
"2695","24",7,"reciprocity",1612,380,60,440,1
"2696","24",8,"reciprocity",1359,220,320,540,1
"2697","24",9,"reciprocity",1935,320,220,540,0
"2698","24",10,"empathy",3575,320,220,540,1
"2699","24",11,"empathy",1332,160,360,520,1
"2700","24",12,"empathy",1703,180,340,520,1
"2702","24",14,"empathy",1646,60,380,440,1
"2703","24",15,"empathy",1102,40,380,420,1
"2705","24",17,"empathy",2314,360,120,480,1
"2706","24",18,"empathy",1485,160,360,520,1
"2707","24",19,"empathy",891,100,380,480,1
"2708","24",20,"empathy",1284,120,360,480,1
"2709","24",21,"empathy",2741,380,60,440,1
"2710","24",22,"empathy",2399,380,40,420,0
"2711","24",23,"empathy",1828,360,120,480,1
"2712","24",24,"empathy",2878,380,20,400,1
"2713","24",25,"reciprocity",2891,380,40,420,1
"2714","24",26,"reciprocity",1895,320,220,540,1
"2715","24",27,"reciprocity",1480,180,340,520,1
"2716","24",28,"reciprocity",1270,160,360,520,1
"2717","24",29,"reciprocity",1975,240,300,540,0
"2718","24",30,"reciprocity",2243,220,320,540,1
"2719","24",31,"reciprocity",2898,380,100,480,1
"2720","24",32,"reciprocity",1071,20,380,400,1
"2721","24",33,"reciprocity",2180,380,60,440,0
"2722","24",34,"empathy",2362,280,280,560,1
"2723","24",35,"empathy",1190,220,320,540,1
"2724","24",36,"empathy",1497,360,160,520,1
"2725","24",37,"empathy",945,180,340,520,1
"2726","24",38,"empathy",1845,380,20,400,0
"2728","24",40,"empathy",740,20,380,400,1
"2729","24",41,"empathy",1397,280,280,560,1
"2731","24",43,"empathy",1137,20,380,400,1
"2732","24",44,"empathy",1165,120,360,480,1
"2733","24",45,"empathy",990,60,380,440,1
"2734","24",46,"reciprocity",2540,160,360,520,1
"2735","24",47,"reciprocity",2066,100,380,480,1
"2736","24",48,"reciprocity",1497,280,280,560,1
"2738","24",50,"reciprocity",996,40,380,420,1
"2739","24",51,"reciprocity",2220,380,100,480,0
"2740","24",52,"empathy",1432,340,180,520,1
"2741","24",53,"empathy",2363,40,380,420,1
"2742","24",54,"empathy",2280,360,160,520,1
"2744","24",56,"reciprocity",2093,60,380,440,1
"2745","24",57,"reciprocity",1758,280,280,560,1
"2746","24",58,"empathy",2452,380,100,480,1
"2747","24",59,"empathy",2533,380,40,420,1
"2748","24",60,"empathy",3096,300,240,540,0
"2749","24",61,"empathy",2253,380,100,480,1
"2750","24",62,"empathy",1945,100,380,480,1
"2751","24",63,"empathy",936,320,220,540,1
"2752","24",64,"reciprocity",2417,300,240,540,1
"2754","24",66,"reciprocity",179,120,360,480,1
"2755","24",67,"empathy",1927,340,180,520,1
"2757","24",69,"empathy",2754,380,60,440,1
"2758","24",70,"reciprocity",2290,360,160,520,1
"2759","24",71,"reciprocity",3507,380,40,420,0
"2760","24",72,"reciprocity",1274,60,380,440,1
"2761","24",73,"reciprocity",1293,340,180,520,1
"2762","24",74,"reciprocity",2531,360,160,520,1
"2763","24",75,"reciprocity",1270,300,240,540,1
"2765","24",77,"reciprocity",2758,380,20,400,0
"2766","24",78,"reciprocity",1971,360,120,480,1
"2767","24",79,"reciprocity",2201,380,20,400,0
"2768","24",80,"reciprocity",3037,40,380,420,1
"2769","24",81,"reciprocity",1144,100,380,480,1
"2770","24",82,"reciprocity",1196,120,360,480,1
"2771","24",83,"reciprocity",1909,240,300,540,1
"2772","24",84,"reciprocity",2583,20,380,400,1
"2774","25",2,"reciprocity",2904,180,340,520,1
"2775","25",3,"reciprocity",2213,20,380,400,1
"2776","25",4,"empathy",2469,380,60,440,1
"2777","25",5,"empathy",1923,220,320,540,1
"2778","25",6,"empathy",1135,40,380,420,1
"2779","25",7,"reciprocity",3529,340,180,520,1
"2781","25",9,"reciprocity",1231,180,340,520,1
"2782","25",10,"empathy",1784,280,280,560,0
"2783","25",11,"empathy",1770,20,380,400,1
"2784","25",12,"empathy",2557,380,60,440,1
"2785","25",13,"empathy",1989,340,180,520,1
"2786","25",14,"empathy",1490,40,380,420,1
"2787","25",15,"empathy",3437,380,40,420,1
"2789","25",17,"empathy",2329,380,100,480,1
"2790","25",18,"empathy",1518,100,380,480,1
"2791","25",19,"reciprocity",2718,340,180,520,1
"2792","25",20,"reciprocity",1999,220,320,540,1
"2793","25",21,"reciprocity",2232,40,380,420,1
"2794","25",22,"empathy",1394,180,340,520,1
"2795","25",23,"empathy",1607,300,240,540,1
"2796","25",24,"empathy",1659,120,360,480,1
"2797","25",25,"reciprocity",1704,380,40,420,1
"2798","25",26,"reciprocity",1041,100,380,480,1
"2800","25",28,"empathy",1771,280,280,560,0
"2801","25",29,"empathy",1263,300,240,540,1
"2803","25",31,"reciprocity",1859,380,20,400,1
"2804","25",32,"reciprocity",2609,100,380,480,1
"2805","25",33,"reciprocity",1709,60,380,440,1
"2806","25",34,"reciprocity",1963,360,160,520,1
"2807","25",35,"reciprocity",1432,380,100,480,1
"2808","25",36,"reciprocity",1451,300,240,540,1
"2809","25",37,"empathy",2451,20,380,400,1
"2810","25",38,"empathy",2037,120,360,480,1
"2811","25",39,"empathy",1382,240,300,540,1
"2812","25",40,"reciprocity",2608,360,120,480,1
"2813","25",41,"reciprocity",1160,320,220,540,1
"2814","25",42,"reciprocity",987,240,300,540,1
"2815","25",43,"reciprocity",1547,220,320,540,1
"2816","25",44,"reciprocity",2903,280,280,560,0
"2817","25",45,"reciprocity",3232,380,100,480,1
"2818","25",46,"reciprocity",1564,40,380,420,1
"2819","25",47,"reciprocity",1378,240,300,540,1
"2820","25",48,"reciprocity",1553,120,360,480,1
"2821","25",49,"empathy",2142,360,120,480,1
"2822","25",50,"empathy",1079,380,40,420,0
"2823","25",51,"empathy",1424,180,340,520,1
"2824","25",52,"reciprocity",2308,60,380,440,1
"2825","25",53,"reciprocity",1363,20,380,400,1
"2826","25",54,"reciprocity",980,160,360,520,1
"2827","25",55,"empathy",1146,160,360,520,1
"2828","25",56,"empathy",2016,60,380,440,1
"2829","25",57,"empathy",1101,220,320,540,0
"2830","25",58,"empathy",1713,160,360,520,1
"2831","25",59,"empathy",1444,380,100,480,1
"2833","25",61,"empathy",3420,380,20,400,1
"2834","25",62,"empathy",1570,360,160,520,1
"2835","25",63,"empathy",1541,320,220,540,1
"2836","25",64,"empathy",1272,240,300,540,1
"2837","25",65,"empathy",2160,360,120,480,1
"2838","25",66,"empathy",1281,60,380,440,1
"2841","25",69,"reciprocity",1429,120,360,480,0
"2842","25",70,"reciprocity",2198,360,160,520,0
"2843","25",71,"reciprocity",3049,380,40,420,0
"2844","25",72,"reciprocity",2433,160,360,520,1
"2845","25",73,"empathy",2176,340,180,520,1
"2846","25",74,"empathy",2236,320,220,540,1
"2847","25",75,"empathy",2244,380,20,400,1
"2848","25",76,"empathy",1241,360,160,520,1
"2850","25",78,"empathy",1600,100,380,480,1
"2851","25",79,"reciprocity",1577,300,240,540,0
"2852","25",80,"reciprocity",2306,380,60,440,0
"2853","25",81,"reciprocity",2175,360,120,480,0
"2855","25",83,"reciprocity",1958,280,280,560,1
"2856","25",84,"reciprocity",2469,380,20,400,0
"2857","26",1,"empathy",2339,180,340,520,1
"2858","26",2,"empathy",2695,20,380,400,0
"2859","26",3,"empathy",1380,100,380,480,1
"2860","26",4,"empathy",1947,100,380,480,1
"2862","26",6,"empathy",2289,380,20,400,0
"2864","26",8,"reciprocity",3303,300,240,540,1
"2865","26",9,"reciprocity",2621,380,40,420,0
"2866","26",10,"empathy",2467,220,320,540,1
"2867","26",11,"empathy",2234,320,220,540,1
"2868","26",12,"empathy",2023,380,20,400,1
"2869","26",13,"reciprocity",2652,380,20,400,1
"2870","26",14,"reciprocity",2110,180,340,520,0
"2871","26",15,"reciprocity",2144,360,160,520,1
"2872","26",16,"reciprocity",1196,360,160,520,1
"2873","26",17,"reciprocity",3406,320,220,540,0
"2874","26",18,"reciprocity",2517,280,280,560,1
"2876","26",20,"reciprocity",1977,380,100,480,1
"2877","26",21,"reciprocity",1654,380,20,400,1
"2878","26",22,"reciprocity",2435,380,40,420,1
"2879","26",23,"reciprocity",1577,340,180,520,1
"2880","26",24,"reciprocity",3859,280,280,560,1
"2881","26",25,"empathy",1395,120,360,480,1
"2882","26",26,"empathy",1952,380,100,480,1
"2883","26",27,"empathy",1293,180,340,520,1
"2884","26",28,"empathy",2763,340,180,520,0
"2885","26",29,"empathy",2537,380,100,480,1
"2886","26",30,"empathy",1046,240,300,540,1
"2887","26",31,"empathy",1518,380,60,440,1
"2889","26",33,"empathy",1231,40,380,420,1
"2890","26",34,"reciprocity",1702,300,240,540,0
"2891","26",35,"reciprocity",1750,220,320,540,1
"2892","26",36,"reciprocity",1329,340,180,520,0
"2893","26",37,"empathy",1258,300,240,540,1
"2895","26",39,"empathy",936,160,360,520,1
"2896","26",40,"empathy",3276,340,180,520,1
"2897","26",41,"empathy",1495,360,120,480,1
"2898","26",42,"empathy",3498,220,320,540,0
"2899","26",43,"empathy",1570,320,220,540,1
"2900","26",44,"empathy",1552,60,380,440,1
"2901","26",45,"empathy",1715,360,120,480,1
"2902","26",46,"reciprocity",1708,60,380,440,0
"2903","26",47,"reciprocity",2276,220,320,540,1
"2904","26",48,"reciprocity",2168,360,120,480,0
"2906","26",50,"empathy",1201,160,360,520,1
"2907","26",51,"empathy",1399,360,160,520,1
"2908","26",52,"empathy",1111,120,360,480,1
"2909","26",53,"empathy",1807,20,380,400,1
"2910","26",54,"empathy",2569,300,240,540,1
"2911","26",55,"reciprocity",1118,180,340,520,1
"2912","26",56,"reciprocity",2472,380,100,480,0
"2914","26",58,"empathy",997,360,160,520,1
"2915","26",59,"empathy",963,280,280,560,1
"2917","26",61,"reciprocity",2136,240,300,540,1
"2918","26",62,"reciprocity",2474,60,380,440,1
"2919","26",63,"reciprocity",3144,20,380,400,0
"2920","26",64,"reciprocity",1311,40,380,420,0
"2922","26",66,"reciprocity",1320,240,300,540,0
"2923","26",67,"reciprocity",1596,120,360,480,0
"2924","26",68,"reciprocity",1267,100,380,480,1
"2925","26",69,"reciprocity",1534,120,360,480,1
"2926","26",70,"reciprocity",1262,160,360,520,0
"2927","26",71,"reciprocity",1168,100,380,480,1
"2928","26",72,"reciprocity",1074,40,380,420,1
"2929","26",73,"empathy",830,380,40,420,1
"2930","26",74,"empathy",1107,280,280,560,1
"2931","26",75,"empathy",1612,380,40,420,1
"2932","26",76,"empathy",1212,60,380,440,1
"2933","26",77,"empathy",1416,380,60,440,0
"2934","26",78,"empathy",1013,40,380,420,1
"2936","26",80,"reciprocity",1779,320,220,540,1
"2937","26",81,"reciprocity",1083,360,120,480,1
"2938","26",82,"reciprocity",1511,20,380,400,0
"2939","26",83,"reciprocity",1205,380,60,440,0
"2940","26",84,"reciprocity",2165,380,60,440,0
"2941","27",1,"reciprocity",1746,360,160,520,1
"2942","27",2,"reciprocity",1183,100,380,480,1
"2943","27",3,"reciprocity",1251,360,120,480,1
"2944","27",4,"reciprocity",835,360,120,480,1
"2945","27",5,"reciprocity",840,380,100,480,1
"2946","27",6,"reciprocity",811,60,380,440,1
"2947","27",7,"reciprocity",738,220,320,540,1
"2948","27",8,"reciprocity",1322,240,300,540,1
"2949","27",9,"reciprocity",1852,240,300,540,1
"2950","27",10,"empathy",2783,380,100,480,1
"2951","27",11,"empathy",3211,360,120,480,1
"2952","27",12,"empathy",823,40,380,420,1
"2953","27",13,"empathy",1185,180,340,520,1
"2954","27",14,"empathy",1224,180,340,520,1
"2955","27",15,"empathy",1047,120,360,480,1
"2956","27",16,"reciprocity",2523,320,220,540,1
"2959","27",19,"empathy",1026,100,380,480,1
"2960","27",20,"empathy",966,20,380,400,1
"2961","27",21,"empathy",962,160,360,520,1
"2962","27",22,"reciprocity",1480,280,280,560,1
"2963","27",23,"reciprocity",1054,120,360,480,0
"2964","27",24,"reciprocity",2071,180,340,520,1
"2965","27",25,"empathy",1983,20,380,400,1
"2966","27",26,"empathy",997,300,240,540,1
"2967","27",27,"empathy",1695,340,180,520,1
"2968","27",28,"empathy",1330,360,160,520,1
"2969","27",29,"empathy",1081,320,220,540,1
"2971","27",31,"reciprocity",2038,380,40,420,1
"2972","27",32,"reciprocity",1681,380,20,400,0
"2973","27",33,"reciprocity",1256,100,380,480,1
"2974","27",34,"reciprocity",2568,300,240,540,1
"2975","27",35,"reciprocity",1299,20,380,400,1
"2976","27",36,"reciprocity",1509,320,220,540,1
"2977","27",37,"empathy",2274,380,40,420,1
"2978","27",38,"empathy",1227,320,220,540,1
"2979","27",39,"empathy",1046,60,380,440,1
"2980","27",40,"reciprocity",1532,180,340,520,1
"2981","27",41,"reciprocity",1329,160,360,520,0
"2982","27",42,"reciprocity",1565,40,380,420,0
"2983","27",43,"empathy",1367,380,60,440,0
"2984","27",44,"empathy",796,280,280,560,1
"2985","27",45,"empathy",1659,380,20,400,1
"2986","27",46,"reciprocity",846,280,280,560,1
"2987","27",47,"reciprocity",770,160,360,520,1
"2988","27",48,"reciprocity",2760,380,100,480,1
"2989","27",49,"reciprocity",889,220,320,540,1
"2991","27",51,"reciprocity",2056,300,240,540,0
"2992","27",52,"reciprocity",1516,380,20,400,1
"2993","27",53,"reciprocity",1016,40,380,420,1
"2994","27",54,"reciprocity",1007,340,180,520,1
"2995","27",55,"empathy",2387,360,120,480,1
"2997","27",57,"empathy",1179,380,20,400,0
"2999","27",59,"reciprocity",1169,360,160,520,1
"3000","27",60,"reciprocity",3340,380,40,420,0
"3002","27",62,"reciprocity",1728,340,180,520,1
"3003","27",63,"reciprocity",1011,20,380,400,1
"3005","27",65,"empathy",1675,380,40,420,1
"3006","27",66,"empathy",1612,360,160,520,1
"3007","27",67,"reciprocity",1191,380,60,440,1
"3008","27",68,"reciprocity",1106,120,360,480,1
"3009","27",69,"reciprocity",1464,60,380,440,1
"3010","27",70,"empathy",2515,340,180,520,1
"3011","27",71,"empathy",679,220,320,540,1
"3012","27",72,"empathy",1284,240,300,540,1
"3013","27",73,"empathy",937,60,380,440,1
"3014","27",74,"empathy",1535,280,280,560,1
"3016","27",76,"empathy",812,100,380,480,1
"3017","27",77,"empathy",759,160,360,520,1
"3018","27",78,"empathy",668,40,380,420,1
"3019","27",79,"empathy",924,380,100,480,1
"3020","27",80,"empathy",773,120,360,480,1
"3021","27",81,"empathy",1259,300,240,540,1
"3022","27",82,"empathy",1468,240,300,540,1
"3023","27",83,"empathy",1154,220,320,540,1
"3024","27",84,"empathy",2594,380,60,440,1
"3025","28",1,"empathy",1433,320,220,540,1
"3027","28",3,"empathy",1910,160,360,520,1
"3028","28",4,"empathy",2231,240,300,540,1
"3029","28",5,"empathy",2290,20,380,400,1
"3031","28",7,"empathy",3759,380,100,480,1
"3032","28",8,"empathy",2391,180,340,520,1
"3033","28",9,"empathy",3852,360,160,520,1
"3035","28",11,"reciprocity",1894,360,120,480,1
"3037","28",13,"reciprocity",3680,180,340,520,1
"3038","28",14,"reciprocity",1702,240,300,540,1
"3039","28",15,"reciprocity",3372,280,280,560,1
"3040","28",16,"reciprocity",1563,300,240,540,1
"3041","28",17,"reciprocity",1513,100,380,480,1
"3042","28",18,"reciprocity",1539,20,380,400,1
"3043","28",19,"empathy",1868,40,380,420,1
"3045","28",21,"empathy",1480,160,360,520,1
"3046","28",22,"empathy",2302,380,60,440,1
"3048","28",24,"empathy",1817,60,380,440,1
"3049","28",25,"reciprocity",3515,360,160,520,1
"3050","28",26,"reciprocity",3036,380,60,440,0
"3051","28",27,"reciprocity",2668,40,380,420,1
"3053","28",29,"reciprocity",2636,380,20,400,0
"3054","28",30,"reciprocity",2512,120,360,480,1
"3055","28",31,"empathy",2014,180,340,520,1
"3056","28",32,"empathy",2056,280,280,560,1
"3057","28",33,"empathy",1263,100,380,480,1
"3058","28",34,"reciprocity",1864,120,360,480,1
"3059","28",35,"reciprocity",1544,220,320,540,1
"3060","28",36,"reciprocity",1216,160,360,520,1
"3062","28",38,"reciprocity",2271,380,100,480,1
"3063","28",39,"reciprocity",1199,40,380,420,1
"3064","28",40,"reciprocity",1399,320,220,540,1
"3065","28",41,"reciprocity",1284,60,380,440,1
"3067","28",43,"empathy",1049,60,380,440,1
"3068","28",44,"empathy",3304,360,120,480,0
"3069","28",45,"empathy",935,380,100,480,1
"3070","28",46,"reciprocity",1320,180,340,520,1
"3071","28",47,"reciprocity",1010,240,300,540,1
"3072","28",48,"reciprocity",3044,380,40,420,1
"3073","28",49,"empathy",161,380,40,420,0
"3074","28",50,"empathy",1860,100,380,480,1
"3075","28",51,"empathy",1367,220,320,540,1
"3076","28",52,"reciprocity",1865,220,320,540,1
"3078","28",54,"reciprocity",2298,380,100,480,1
"3079","28",55,"empathy",1361,360,160,520,1
"3080","28",56,"empathy",853,320,220,540,1
"3081","28",57,"empathy",1181,220,320,540,1
"3082","28",58,"empathy",1703,120,360,480,1
"3083","28",59,"empathy",1582,380,20,400,1
"3085","28",61,"reciprocity",1301,20,380,400,1
"3086","28",62,"reciprocity",962,340,180,520,1
"3087","28",63,"reciprocity",1445,380,60,440,1
"3088","28",64,"empathy",851,300,240,540,1
"3089","28",65,"empathy",903,120,360,480,1
"3090","28",66,"empathy",1629,240,300,540,0
"3091","28",67,"empathy",1267,40,380,420,1
"3092","28",68,"empathy",779,20,380,400,1
"3093","28",69,"empathy",1384,280,280,560,1
"3094","28",70,"reciprocity",1351,280,280,560,1
"3095","28",71,"reciprocity",1544,160,360,520,1
"3096","28",72,"reciprocity",817,100,380,480,1
"3097","28",73,"empathy",1226,340,180,520,1
"3098","28",74,"empathy",1266,300,240,540,1
"3099","28",75,"empathy",999,360,120,480,1
"3100","28",76,"reciprocity",1561,380,40,420,1
"3102","28",78,"reciprocity",2226,300,240,540,1
"3103","28",79,"reciprocity",1071,360,160,520,1
"3104","28",80,"reciprocity",1297,60,380,440,1
"3105","28",81,"reciprocity",2318,360,120,480,1
"3106","28",82,"empathy",2993,380,40,420,1
"3107","28",83,"empathy",1789,340,180,520,1
"3108","28",84,"empathy",1496,380,60,440,1
"3109","29",1,"empathy",1855,300,240,540,1
"3111","29",3,"empathy",2016,340,180,520,1
"3112","29",4,"reciprocity",1625,300,240,540,1
"3113","29",5,"reciprocity",1971,380,100,480,1
"3114","29",6,"reciprocity",1062,320,220,540,1
"3115","29",7,"reciprocity",1465,240,300,540,1
"3116","29",8,"reciprocity",1920,120,360,480,1
"3117","29",9,"reciprocity",1420,160,360,520,1
"3119","29",11,"reciprocity",1067,180,340,520,1
"3120","29",12,"reciprocity",1496,40,380,420,1
"3121","29",13,"empathy",1066,280,280,560,1
"3122","29",14,"empathy",1003,120,360,480,1
"3123","29",15,"empathy",2487,380,40,420,1
"3124","29",16,"reciprocity",1008,300,240,540,1
"3125","29",17,"reciprocity",823,120,360,480,1
"3126","29",18,"reciprocity",1077,380,20,400,0
"3127","29",19,"reciprocity",1466,380,60,440,1
"3128","29",20,"reciprocity",1631,360,160,520,1
"3129","29",21,"reciprocity",1141,160,360,520,1
"3130","29",22,"empathy",1296,40,380,420,1
"3131","29",23,"empathy",1125,280,280,560,1
"3132","29",24,"empathy",999,100,380,480,1
"3133","29",25,"empathy",1022,20,380,400,1
"3134","29",26,"empathy",928,380,20,400,0
"3135","29",27,"empathy",1336,320,220,540,1
"3136","29",28,"empathy",1373,60,380,440,1
"3137","29",29,"empathy",1656,360,120,480,1
"3138","29",30,"empathy",1128,180,340,520,1
"3139","29",31,"reciprocity",1148,320,220,540,1
"3140","29",32,"reciprocity",874,20,380,400,1
"3141","29",33,"reciprocity",1124,360,160,520,1
"3142","29",34,"empathy",1144,20,380,400,1
"3143","29",35,"empathy",1183,300,240,540,1
"3144","29",36,"empathy",1193,240,300,540,1
"3145","29",37,"empathy",968,180,340,520,1
"3146","29",38,"empathy",862,220,320,540,1
"3148","29",40,"reciprocity",2346,340,180,520,1
"3149","29",41,"reciprocity",1193,60,380,440,1
"3150","29",42,"reciprocity",2073,360,120,480,1
"3152","29",44,"empathy",1734,380,60,440,1
"3153","29",45,"empathy",938,380,100,480,1
"3155","29",47,"reciprocity",920,360,120,480,1
"3156","29",48,"reciprocity",2284,380,100,480,1
"3157","29",49,"reciprocity",849,40,380,420,1
"3158","29",50,"reciprocity",1652,380,20,400,1
"3159","29",51,"reciprocity",1494,380,40,420,1
"3160","29",52,"reciprocity",967,280,280,560,1
"3161","29",53,"reciprocity",1389,220,320,540,1
"3162","29",54,"reciprocity",1273,240,300,540,1
"3163","29",55,"reciprocity",2000,380,60,440,1
"3164","29",56,"reciprocity",963,20,380,400,1
"3166","29",58,"empathy",1040,320,220,540,1
"3167","29",59,"empathy",848,120,360,480,1
"3168","29",60,"empathy",998,60,380,440,1
"3169","29",61,"empathy",1434,360,120,480,1
"3170","29",62,"empathy",1137,360,160,520,1
"3171","29",63,"empathy",1388,380,60,440,1
"3172","29",64,"empathy",942,40,380,420,1
"3173","29",65,"empathy",2098,380,20,400,1
"3174","29",66,"empathy",764,240,300,540,1
"3175","29",67,"reciprocity",1155,280,280,560,1
"3176","29",68,"reciprocity",780,100,380,480,1
"3177","29",69,"reciprocity",786,220,320,540,1
"3178","29",70,"reciprocity",786,340,180,520,1
"3179","29",71,"reciprocity",1004,100,380,480,1
"3180","29",72,"reciprocity",1593,180,340,520,0
"3181","29",73,"empathy",1873,380,40,420,0
"3182","29",74,"empathy",978,100,380,480,0
"3183","29",75,"empathy",748,220,320,540,0
"3184","29",76,"empathy",863,160,360,520,1
"3185","29",77,"empathy",1284,160,360,520,1
"3186","29",78,"empathy",1322,380,100,480,1
"3188","29",80,"empathy",1086,360,160,520,1
"3189","29",81,"empathy",1173,340,180,520,1
"3191","29",83,"reciprocity",1217,380,40,420,1
"3192","29",84,"reciprocity",962,60,380,440,1
"3194","30",2,"multi-motive",1677,360,120,480,1
"3195","30",3,"multi-motive",1753,380,100,480,1
"3196","30",4,"multi-motive",1683,360,160,520,1
"3197","30",5,"multi-motive",1518,100,380,480,1
"3198","30",6,"multi-motive",1157,320,220,540,1
"3199","30",7,"control",2024,380,20,400,0
"3200","30",8,"control",1764,300,240,540,1
"3201","30",9,"control",2012,100,380,480,1
"3202","30",10,"multi-motive",803,160,360,520,1
"3203","30",11,"multi-motive",1832,280,280,560,1
"3204","30",12,"multi-motive",1705,300,240,540,1
"3205","30",13,"control",2173,180,340,520,1
"3206","30",14,"control",2291,120,360,480,1
"3207","30",15,"control",1454,220,320,540,1
"3208","30",16,"multi-motive",1303,220,320,540,1
"3209","30",17,"multi-motive",1764,180,340,520,1
"3210","30",18,"multi-motive",1335,160,360,520,1
"3211","30",19,"multi-motive",1226,40,380,420,1
"3212","30",20,"multi-motive",949,60,380,440,1
"3213","30",21,"multi-motive",1344,360,120,480,1
"3214","30",22,"control",1754,240,300,540,1
"3215","30",23,"control",1683,380,60,440,0
"3216","30",24,"control",1687,320,220,540,1
"3217","30",25,"control",1122,160,360,520,1
"3218","30",26,"control",1728,220,320,540,1
"3219","30",27,"control",2483,380,40,420,0
"3220","30",28,"control",1060,180,340,520,1
"3221","30",29,"control",1478,280,280,560,1
"3222","30",30,"control",2311,360,160,520,1
"3225","30",33,"multi-motive",1063,100,380,480,1
"3226","30",34,"control",1541,360,160,520,1
"3227","30",35,"control",1726,380,60,440,1
"3228","30",36,"control",1981,380,100,480,1
"3229","30",37,"multi-motive",952,360,160,520,1
"3230","30",38,"multi-motive",1394,60,380,440,1
"3232","30",40,"multi-motive",1011,220,320,540,1
"3233","30",41,"multi-motive",770,240,300,540,1
"3234","30",42,"multi-motive",1078,340,180,520,1
"3235","30",43,"control",1361,320,220,540,1
"3236","30",44,"control",1961,160,360,520,1
"3238","30",46,"multi-motive",1024,300,240,540,1
"3239","30",47,"multi-motive",1611,180,340,520,1
"3240","30",48,"multi-motive",2627,340,180,520,1
"3241","30",49,"multi-motive",712,40,380,420,1
"3242","30",50,"multi-motive",1633,380,20,400,0
"3243","30",51,"multi-motive",1417,380,20,400,1
"3244","30",52,"control",2094,20,380,400,1
"3247","30",55,"control",2025,300,240,540,0
"3248","30",56,"control",795,280,280,560,1
"3249","30",57,"control",1959,120,360,480,1
"3250","30",58,"multi-motive",1017,380,40,420,1
"3251","30",59,"multi-motive",1820,380,100,480,1
"3252","30",60,"multi-motive",1027,20,380,400,1
"3253","30",61,"multi-motive",1528,120,360,480,1
"3254","30",62,"multi-motive",1305,120,360,480,1
"3255","30",63,"multi-motive",906,240,300,540,1
"3256","30",64,"control",1838,360,120,480,0
"3257","30",65,"control",1862,380,20,400,1
"3258","30",66,"control",1319,240,300,540,1
"3259","30",67,"control",1460,60,380,440,1
"3260","30",68,"control",2515,380,40,420,1
"3261","30",69,"control",1124,40,380,420,1
"3262","30",70,"control",1958,20,380,400,1
"3263","30",71,"control",1737,360,120,480,1
"3264","30",72,"control",1898,380,100,480,1
"3265","30",73,"control",2253,340,180,520,1
"3267","30",75,"control",1581,60,380,440,1
"3268","30",76,"multi-motive",745,380,60,440,1
"3269","30",77,"multi-motive",1185,20,380,400,1
"3270","30",78,"multi-motive",1001,280,280,560,1
"3271","30",79,"control",1541,340,180,520,1
"3272","30",80,"control",1300,100,380,480,1
"3273","30",81,"control",1405,40,380,420,1
"3274","30",82,"multi-motive",1171,320,220,540,1
"3275","30",83,"multi-motive",1692,380,60,440,1
"3276","30",84,"multi-motive",1333,380,40,420,1
"3277","31",1,"control",1471,120,360,480,1
"3279","31",3,"control",2542,100,380,480,1
"3280","31",4,"multi-motive",2215,380,60,440,0
"3281","31",5,"multi-motive",3651,240,300,540,1
"3282","31",6,"multi-motive",2409,340,180,520,0
"3284","31",8,"multi-motive",1980,340,180,520,1
"3285","31",9,"multi-motive",2980,380,20,400,0
"3286","31",10,"multi-motive",1883,180,340,520,1
"3287","31",11,"multi-motive",1596,320,220,540,1
"3288","31",12,"multi-motive",3134,300,240,540,1
"3289","31",13,"multi-motive",2039,160,360,520,1
"3291","31",15,"multi-motive",3663,380,100,480,0
"3292","31",16,"multi-motive",2569,380,40,420,0
"3293","31",17,"multi-motive",1908,100,380,480,1
"3294","31",18,"multi-motive",2043,220,320,540,1
"3295","31",19,"multi-motive",3079,100,380,480,1
"3296","31",20,"multi-motive",2212,120,360,480,1
"3297","31",21,"multi-motive",1798,40,380,420,1
"3298","31",22,"control",2028,360,160,520,0
"3299","31",23,"control",1383,60,380,440,1
"3301","31",25,"control",3042,380,100,480,0
"3302","31",26,"control",1951,280,280,560,1
"3303","31",27,"control",2103,40,380,420,1
"3304","31",28,"control",2766,320,220,540,1
"3305","31",29,"control",2193,300,240,540,1
"3306","31",30,"control",1917,220,320,540,1
"3307","31",31,"control",1393,40,380,420,1
"3308","31",32,"control",2360,240,300,540,1
"3309","31",33,"control",2207,380,40,420,0
"3310","31",34,"multi-motive",1962,360,120,480,1
"3311","31",35,"multi-motive",1684,120,360,480,1
"3312","31",36,"multi-motive",1680,380,20,400,0
"3313","31",37,"control",2791,380,20,400,0
"3314","31",38,"control",1749,380,60,440,0
"3315","31",39,"control",2123,380,40,420,0
"3316","31",40,"control",1704,220,320,540,1
"3317","31",41,"control",1892,180,340,520,1
"3318","31",42,"control",1320,100,380,480,1
"3319","31",43,"control",1833,240,300,540,1
"3321","31",45,"control",2109,20,380,400,1
"3322","31",46,"multi-motive",1545,40,380,420,1
"3323","31",47,"multi-motive",2855,380,60,440,1
"3324","31",48,"multi-motive",2823,360,120,480,0
"3325","31",49,"control",3171,380,60,440,0
"3326","31",50,"control",1769,160,360,520,1
"3327","31",51,"control",2741,360,120,480,0
"3328","31",52,"control",986,20,380,400,1
"3329","31",53,"control",2448,340,180,520,0
"3330","31",54,"control",1604,180,340,520,1
"3331","31",55,"control",3344,300,240,540,0
"3332","31",56,"control",2409,280,280,560,1
"3333","31",57,"control",2986,320,220,540,0
"3335","31",59,"multi-motive",1645,180,340,520,1
"3336","31",60,"multi-motive",2444,20,380,400,1
"3338","31",62,"multi-motive",1168,20,380,400,1
"3339","31",63,"multi-motive",1845,160,360,520,1
"3340","31",64,"multi-motive",1845,300,240,540,1
"3341","31",65,"multi-motive",1378,280,280,560,1
"3342","31",66,"multi-motive",2376,320,220,540,1
"3343","31",67,"multi-motive",1134,60,380,440,1
"3344","31",68,"multi-motive",2825,360,160,520,1
"3345","31",69,"multi-motive",2491,220,320,540,1
"3346","31",70,"multi-motive",1335,240,300,540,1
"3347","31",71,"multi-motive",2807,60,380,440,1
"3349","31",73,"multi-motive",2346,380,40,420,1
"3350","31",74,"multi-motive",2058,280,280,560,1
"3351","31",75,"multi-motive",3778,380,100,480,1
"3352","31",76,"control",1684,60,380,440,1
"3353","31",77,"control",1929,160,360,520,1
"3355","31",79,"control",2042,380,20,400,0
"3356","31",80,"control",1556,120,360,480,1
"3357","31",81,"control",2524,340,180,520,0
"3358","31",82,"control",1698,360,120,480,0
"3359","31",83,"control",1976,360,160,520,1
"3360","31",84,"control",3470,380,100,480,0
"3361","32",1,"multi-motive",2941,240,300,540,1
"3363","32",3,"multi-motive",3932,220,320,540,1
"3364","32",4,"control",2582,380,40,420,0
"3365","32",5,"control",2348,180,340,520,1
"3367","32",7,"control",2136,160,360,520,1
"3369","32",9,"control",2264,340,180,520,0
"3371","32",11,"multi-motive",2697,20,380,400,1
"3372","32",12,"multi-motive",2298,180,340,520,1
"3373","32",13,"multi-motive",2198,120,360,480,1
"3374","32",14,"multi-motive",2335,120,360,480,1
"3375","32",15,"multi-motive",1869,60,380,440,1
"3376","32",16,"control",2864,100,380,480,1
"3377","32",17,"control",2865,280,280,560,1
"3378","32",18,"control",2696,240,300,540,1
"3380","32",20,"control",1268,120,360,480,1
"3381","32",21,"control",2465,220,320,540,1
"3383","32",23,"multi-motive",2330,340,180,520,0
"3384","32",24,"multi-motive",2581,280,280,560,0
"3385","32",25,"control",2837,300,240,540,1
"3386","32",26,"control",2098,360,120,480,1
"3387","32",27,"control",1951,20,380,400,0
"3388","32",28,"control",3198,380,100,480,0
"3389","32",29,"control",3563,380,60,440,0
"3390","32",30,"control",3495,300,240,540,1
"3391","32",31,"control",3368,360,160,520,1
"3392","32",32,"control",1470,40,380,420,1
"3393","32",33,"control",2345,180,340,520,1
"3394","32",34,"multi-motive",1032,60,380,440,1
"3395","32",35,"multi-motive",1031,100,380,480,1
"3397","32",37,"control",1130,20,380,400,1
"3398","32",38,"control",2738,380,20,400,0
"3399","32",39,"control",2117,360,160,520,0
"3400","32",40,"multi-motive",1118,180,340,520,1
"3401","32",41,"multi-motive",3553,380,20,400,0
"3402","32",42,"multi-motive",2329,380,60,440,0
"3403","32",43,"control",2753,280,280,560,1
"3404","32",44,"control",1946,360,120,480,0
"3405","32",45,"control",1090,120,360,480,1
"3406","32",46,"control",1834,380,60,440,0
"3407","32",47,"control",2090,380,100,480,0
"3408","32",48,"control",2137,380,20,400,0
"3409","32",49,"multi-motive",1720,160,360,520,1
"3410","32",50,"multi-motive",2464,380,60,440,0
"3411","32",51,"multi-motive",892,320,220,540,1
"3412","32",52,"multi-motive",2542,380,40,420,0
"3413","32",53,"multi-motive",1495,100,380,480,1
"3414","32",54,"multi-motive",1599,380,40,420,0
"3415","32",55,"multi-motive",1798,360,120,480,0
"3416","32",56,"multi-motive",1614,360,120,480,0
"3417","32",57,"multi-motive",3973,320,220,540,1
"3418","32",58,"multi-motive",1251,380,20,400,0
"3419","32",59,"multi-motive",3349,300,240,540,1
"3420","32",60,"multi-motive",1107,240,300,540,1
"3421","32",61,"control",2312,380,40,420,0
"3422","32",62,"control",1713,320,220,540,1
"3424","32",64,"control",1043,100,380,480,1
"3425","32",65,"control",992,240,300,540,1
"3426","32",66,"control",1695,320,220,540,1
"3427","32",67,"control",982,60,380,440,1
"3428","32",68,"control",1335,340,180,520,1
"3429","32",69,"control",1012,160,360,520,1
"3430","32",70,"multi-motive",2157,380,100,480,0
"3431","32",71,"multi-motive",1250,360,160,520,0
"3432","32",72,"multi-motive",923,20,380,400,1
"3434","32",74,"multi-motive",1056,160,360,520,1
"3435","32",75,"multi-motive",1311,40,380,420,1
"3436","32",76,"control",1053,60,380,440,1
"3437","32",77,"control",1126,220,320,540,1
"3438","32",78,"control",764,40,380,420,1
"3439","32",79,"multi-motive",874,300,240,540,1
"3440","32",80,"multi-motive",882,220,320,540,1
"3441","32",81,"multi-motive",2015,380,100,480,0
"3442","32",82,"multi-motive",738,40,380,420,1
"3613","0",1,"reciprocity",928,380,40,420,1
"3614","0",2,"reciprocity",1087,40,380,420,1
"3615","0",3,"reciprocity",697,240,300,540,1
"3616","0",4,"reciprocity",964,380,60,440,1
"3617","0",5,"reciprocity",762,280,280,560,1
"3618","0",6,"reciprocity",1005,180,340,520,1
"3619","0",7,"empathy",967,380,20,400,1
"3620","0",8,"empathy",757,40,380,420,1
"3622","0",10,"empathy",855,340,180,520,1
"3623","0",11,"empathy",807,380,60,440,1
"3624","0",12,"empathy",875,320,220,540,1
"3625","0",13,"reciprocity",651,360,160,520,1
"3626","0",14,"reciprocity",809,20,380,400,1
"3627","0",15,"reciprocity",892,120,360,480,1
"3629","0",17,"empathy",658,220,320,540,1
"3631","0",19,"empathy",894,160,360,520,1
"3632","0",20,"empathy",720,120,360,480,1
"3634","0",22,"empathy",895,220,320,540,1
"3635","0",23,"empathy",797,380,20,400,1
"3636","0",24,"empathy",1089,240,300,540,1
"3637","0",25,"empathy",710,380,40,420,1
"3638","0",26,"empathy",654,20,380,400,1
"3639","0",27,"empathy",883,20,380,400,1
"3640","0",28,"empathy",544,300,240,540,1
"3641","0",29,"empathy",659,60,380,440,1
"3643","0",31,"reciprocity",816,40,380,420,1
"3644","0",32,"reciprocity",597,160,360,520,1
"3646","0",34,"reciprocity",657,340,180,520,1
"3647","0",35,"reciprocity",695,60,380,440,1
"3648","0",36,"reciprocity",1622,340,180,520,1
"3649","0",37,"empathy",788,320,220,540,1
"3650","0",38,"empathy",742,360,120,480,1
"3651","0",39,"empathy",1058,380,40,420,1
"3652","0",40,"empathy",697,360,160,520,1
"3653","0",41,"empathy",654,280,280,560,1
"3654","0",42,"empathy",839,120,360,480,1
"3655","0",43,"empathy",843,240,300,540,1
"3656","0",44,"empathy",808,160,360,520,1
"3657","0",45,"empathy",690,40,380,420,1
"3658","0",46,"empathy",830,380,60,440,1
"3659","0",47,"empathy",782,100,380,480,1
"3660","0",48,"empathy",969,360,120,480,1
"3661","0",49,"empathy",823,340,180,520,1
"3662","0",50,"empathy",906,60,380,440,1
"3663","0",51,"empathy",858,100,380,480,1
"3664","0",52,"reciprocity",975,380,100,480,1
"3665","0",53,"reciprocity",841,320,220,540,1
"3666","0",54,"reciprocity",929,280,280,560,1
"3667","0",55,"reciprocity",844,20,380,400,1
"3669","0",57,"reciprocity",1070,180,340,520,1
"3670","0",58,"reciprocity",762,360,120,480,1
"3671","0",59,"reciprocity",1284,100,380,480,1
"3672","0",60,"reciprocity",801,380,60,440,1
"3673","0",61,"empathy",696,180,340,520,1
"3674","0",62,"empathy",722,280,280,560,1
"3675","0",63,"empathy",617,180,340,520,1
"3677","0",65,"reciprocity",1377,360,120,480,1
"3678","0",66,"reciprocity",988,300,240,540,1
"3679","0",67,"reciprocity",1171,380,20,400,1
"3680","0",68,"reciprocity",1771,320,220,540,1
"3681","0",69,"reciprocity",905,380,40,420,1
"3682","0",70,"reciprocity",573,240,300,540,1
"3683","0",71,"reciprocity",728,300,240,540,1
"3684","0",72,"reciprocity",651,360,160,520,1
"3685","0",73,"reciprocity",816,60,380,440,1
"3686","0",74,"reciprocity",677,220,320,540,1
"3687","0",75,"reciprocity",1056,380,20,400,1
"3689","0",77,"reciprocity",757,100,380,480,1
"3690","0",78,"reciprocity",849,220,320,540,1
"3691","0",79,"empathy",705,300,240,540,1
"3692","0",80,"empathy",836,380,100,480,1
"3693","0",81,"empathy",674,360,160,520,1
"3694","0",82,"reciprocity",739,160,360,520,1
"3695","0",83,"reciprocity",734,120,360,480,1
"3696","0",84,"reciprocity",733,380,100,480,1
"3949","1",1,"control",2089,380,40,420,1
"3950","1",2,"control",1195,380,40,420,0
"3951","1",3,"control",2642,380,60,440,1
"3952","1",4,"control",1128,380,100,480,1
"3953","1",5,"control",2345,20,380,400,0
"3954","1",6,"control",1059,160,360,520,1
"3955","1",7,"multi-motive",1290,380,60,440,1
"3956","1",8,"multi-motive",2094,380,60,440,1
"3957","1",9,"multi-motive",1134,320,220,540,1
"3958","1",10,"multi-motive",1858,380,20,400,1
"3959","1",11,"multi-motive",919,120,360,480,1
"3962","1",14,"control",1273,100,380,480,1
"3963","1",15,"control",1418,160,360,520,1
"3964","1",16,"control",1301,360,160,520,0
"3965","1",17,"control",1124,300,240,540,1
"3966","1",18,"control",1535,340,180,520,1
"3967","1",19,"control",1390,180,340,520,1
"3968","1",20,"control",1091,120,360,480,1
"3969","1",21,"control",1190,220,320,540,1
"3970","1",22,"multi-motive",1775,380,20,400,1
"3971","1",23,"multi-motive",1042,100,380,480,1
"3972","1",24,"multi-motive",1033,280,280,560,1
"3973","1",25,"control",1619,380,60,440,0
"3974","1",26,"control",1266,100,380,480,1
"3975","1",27,"control",2449,380,20,400,0
"3976","1",28,"multi-motive",1452,380,100,480,1
"3977","1",29,"multi-motive",1552,380,40,420,1
"3978","1",30,"multi-motive",1619,380,100,480,1
"3979","1",31,"control",1362,340,180,520,0
"3980","1",32,"control",1710,60,380,440,1
"3981","1",33,"control",1748,360,160,520,1
"3983","1",35,"multi-motive",1481,340,180,520,0
"3984","1",36,"multi-motive",1554,220,320,540,1
"3985","1",37,"control",947,20,380,400,1
"3986","1",38,"control",3370,280,280,560,1
"3988","1",40,"control",1722,300,240,540,1
"3989","1",41,"control",1335,360,120,480,0
"3990","1",42,"control",1568,360,120,480,0
"3991","1",43,"multi-motive",1658,320,220,540,1
"3993","1",45,"multi-motive",2035,360,120,480,1
"3994","1",46,"multi-motive",1060,160,360,520,1
"3995","1",47,"multi-motive",848,180,340,520,1
"3996","1",48,"multi-motive",1119,280,280,560,1
"3997","1",49,"control",1895,120,360,480,1
"3998","1",50,"control",1659,60,380,440,1
"3999","1",51,"control",1528,380,100,480,0
"4001","1",53,"control",1984,180,340,520,1
"4002","1",54,"control",1161,220,320,540,0
"4003","1",55,"multi-motive",2263,380,40,420,1
"4004","1",56,"multi-motive",1045,220,320,540,1
"4005","1",57,"multi-motive",1377,300,240,540,1
"4006","1",58,"multi-motive",978,60,380,440,1
"4007","1",59,"multi-motive",1452,360,160,520,1
"4008","1",60,"multi-motive",1413,180,340,520,1
"4009","1",61,"multi-motive",1226,240,300,540,1
"4010","1",62,"multi-motive",1626,120,360,480,1
"4011","1",63,"multi-motive",1299,360,160,520,0
"4012","1",64,"multi-motive",1283,20,380,400,1
"4013","1",65,"multi-motive",1294,300,240,540,1
"4014","1",66,"multi-motive",1872,60,380,440,1
"4015","1",67,"multi-motive",1704,240,300,540,1
"4016","1",68,"multi-motive",1429,340,180,520,1
"4017","1",69,"multi-motive",1200,40,380,420,1
"4018","1",70,"control",1375,240,300,540,1
"4019","1",71,"control",1839,280,280,560,1
"4020","1",72,"control",1296,240,300,540,1
"4021","1",73,"multi-motive",1275,20,380,400,1
"4023","1",75,"multi-motive",1215,40,380,420,1
"4024","1",76,"control",1299,320,220,540,1
"4025","1",77,"control",1555,320,220,540,1
"4026","1",78,"control",1865,40,380,420,1
"4027","1",79,"control",1609,380,20,400,1
"4028","1",80,"control",1224,40,380,420,1
"4030","1",82,"multi-motive",2143,100,380,480,1
"4031","1",83,"multi-motive",1641,360,120,480,1
"4032","1",84,"multi-motive",1284,160,360,520,1
"4117","2",1,"control",1209,380,40,420,0
"4118","2",2,"control",1718,180,340,520,1
"4119","2",3,"control",1297,100,380,480,1
"4121","2",5,"multi-motive",2349,20,380,400,1
"4122","2",6,"multi-motive",1803,60,380,440,0
"4123","2",7,"multi-motive",1548,340,180,520,0
"4124","2",8,"multi-motive",1662,380,40,420,0
"4125","2",9,"multi-motive",945,100,380,480,1
"4126","2",10,"control",1460,280,280,560,1
"4127","2",11,"control",1158,380,100,480,0
"4128","2",12,"control",1353,380,20,400,0
"4129","2",13,"control",1281,380,40,420,0
"4130","2",14,"control",1904,360,160,520,0
"4132","2",16,"control",2353,380,100,480,0
"4133","2",17,"control",1706,360,120,480,0
"4134","2",18,"control",1361,60,380,440,1
"4135","2",19,"control",1408,60,380,440,1
"4136","2",20,"control",1514,380,60,440,0
"4137","2",21,"control",1924,300,240,540,1
"4139","2",23,"multi-motive",2270,300,240,540,0
"4140","2",24,"multi-motive",1604,220,320,540,0
"4141","2",25,"multi-motive",1376,40,380,420,1
"4142","2",26,"multi-motive",2981,320,220,540,0
"4143","2",27,"multi-motive",2068,240,300,540,0
"4144","2",28,"control",2169,120,360,480,1
"4145","2",29,"control",1140,300,240,540,0
"4146","2",30,"control",1763,20,380,400,1
"4147","2",31,"multi-motive",1533,280,280,560,1
"4148","2",32,"multi-motive",3375,380,100,480,0
"4149","2",33,"multi-motive",1433,220,320,540,1
"4150","2",34,"multi-motive",1781,160,360,520,0
"4151","2",35,"multi-motive",1968,180,340,520,1
"4153","2",37,"multi-motive",1717,380,60,440,0
"4154","2",38,"multi-motive",2047,280,280,560,0
"4155","2",39,"multi-motive",2191,380,20,400,0
"4156","2",40,"multi-motive",1496,20,380,400,1
"4158","2",42,"multi-motive",1250,360,120,480,0
"4159","2",43,"control",2161,20,380,400,1
"4160","2",44,"control",1464,380,20,400,0
"4161","2",45,"control",1718,160,360,520,1
"4162","2",46,"control",2861,180,340,520,0
"4163","2",47,"control",1225,240,300,540,1
"4164","2",48,"control",1465,320,220,540,0
"4165","2",49,"multi-motive",1384,380,60,440,0
"4166","2",50,"multi-motive",1557,160,360,520,1
"4167","2",51,"multi-motive",1104,360,160,520,0
"4168","2",52,"control",2163,240,300,540,0
"4169","2",53,"control",1761,120,360,480,1
"4170","2",54,"control",2203,360,120,480,1
"4171","2",55,"multi-motive",2085,380,40,420,0
"4172","2",56,"multi-motive",813,60,380,440,1
"4173","2",57,"multi-motive",1391,300,240,540,1
"4174","2",58,"control",2267,160,360,520,0
"4175","2",59,"control",2876,380,60,440,0
"4177","2",61,"multi-motive",1626,120,360,480,1
"4178","2",62,"multi-motive",2408,100,380,480,1
"4180","2",64,"multi-motive",1613,120,360,480,0
"4181","2",65,"multi-motive",1907,320,220,540,0
"4182","2",66,"multi-motive",1217,340,180,520,0
"4183","2",67,"control",1832,40,380,420,1
"4184","2",68,"control",1299,360,160,520,0
"4186","2",70,"control",2427,100,380,480,1
"4187","2",71,"control",1003,340,180,520,0
"4188","2",72,"control",2287,220,320,540,1
"4189","2",73,"control",2188,340,180,520,0
"4190","2",74,"control",1366,320,220,540,1
"4191","2",75,"control",2863,40,380,420,1
"4192","2",76,"multi-motive",1576,180,340,520,0
"4193","2",77,"multi-motive",2462,380,20,400,0
"4194","2",78,"multi-motive",1696,360,160,520,1
"4195","2",79,"multi-motive",2617,360,120,480,0
"4196","2",80,"multi-motive",1921,40,380,420,1
"4197","2",81,"multi-motive",1779,380,100,480,0
"4198","2",82,"control",2306,280,280,560,1
"4200","2",84,"control",2538,220,320,540,0
"4201","3",1,"empathy",2108,100,380,480,1
"4202","3",2,"empathy",2246,340,180,520,1
"4203","3",3,"empathy",1911,320,220,540,0
"4204","3",4,"empathy",2740,280,280,560,0
"4205","3",5,"empathy",1269,380,40,420,0
"4207","3",7,"reciprocity",2331,380,100,480,0
"4208","3",8,"reciprocity",1480,300,240,540,1
"4209","3",9,"reciprocity",1967,280,280,560,1
"4210","3",10,"empathy",1367,380,100,480,0
"4211","3",11,"empathy",2551,340,180,520,1
"4212","3",12,"empathy",1451,380,40,420,0
"4213","3",13,"reciprocity",1228,100,380,480,1
"4214","3",14,"reciprocity",1041,220,320,540,1
"4216","3",16,"reciprocity",1346,320,220,540,0
"4217","3",17,"reciprocity",1362,380,20,400,0
"4218","3",18,"reciprocity",1273,40,380,420,1
"4219","3",19,"reciprocity",1324,100,380,480,1
"4220","3",20,"reciprocity",2001,280,280,560,1
"4221","3",21,"reciprocity",1071,160,360,520,1
"4222","3",22,"empathy",1418,20,380,400,1
"4223","3",23,"empathy",1146,220,320,540,1
"4224","3",24,"empathy",1737,380,100,480,0
"4225","3",25,"reciprocity",2049,240,300,540,1
"4226","3",26,"reciprocity",2098,180,340,520,1
"4227","3",27,"reciprocity",1032,180,340,520,1
"4228","3",28,"reciprocity",1210,380,60,440,0
"4229","3",29,"reciprocity",1060,120,360,480,1
"4230","3",30,"reciprocity",2363,380,40,420,0
"4231","3",31,"empathy",1973,120,360,480,1
"4232","3",32,"empathy",2961,360,120,480,0
"4233","3",33,"empathy",1414,60,380,440,1
"4234","3",34,"empathy",1675,380,60,440,0
"4235","3",35,"empathy",1804,300,240,540,1
"4236","3",36,"empathy",1163,40,380,420,1
"4237","3",37,"empathy",1287,180,340,520,1
"4238","3",38,"empathy",1582,60,380,440,0
"4240","3",40,"reciprocity",2069,380,60,440,0
"4241","3",41,"reciprocity",1148,60,380,440,1
"4243","3",43,"reciprocity",2507,120,360,480,1
"4244","3",44,"reciprocity",3203,380,20,400,0
"4245","3",45,"reciprocity",974,20,380,400,1
"4246","3",46,"empathy",2616,240,300,540,1
"4247","3",47,"empathy",2565,360,160,520,0
"4248","3",48,"empathy",2217,320,220,540,1
"4249","3",49,"reciprocity",1871,340,180,520,1
"4250","3",50,"reciprocity",1516,240,300,540,1
"4251","3",51,"reciprocity",1681,360,120,480,1
"4252","3",52,"reciprocity",1348,40,380,420,1
"4253","3",53,"reciprocity",2697,220,320,540,1
"4254","3",54,"reciprocity",1758,300,240,540,0
"4255","3",55,"empathy",1649,160,360,520,1
"4256","3",56,"empathy",1041,180,340,520,1
"4257","3",57,"empathy",1005,240,300,540,1
"4258","3",58,"empathy",1061,160,360,520,1
"4260","3",60,"empathy",799,20,380,400,1
"4261","3",61,"empathy",1805,380,20,400,0
"4262","3",62,"empathy",1663,120,360,480,1
"4263","3",63,"empathy",2473,40,380,420,1
"4264","3",64,"reciprocity",1298,380,40,420,0
"4265","3",65,"reciprocity",2792,380,100,480,0
"4267","3",67,"reciprocity",1173,160,360,520,1
"4268","3",68,"reciprocity",1829,20,380,400,1
"4269","3",69,"reciprocity",2281,360,120,480,0
"4270","3",70,"reciprocity",1612,360,160,520,1
"4272","3",72,"reciprocity",965,60,380,440,1
"4273","3",73,"empathy",1303,100,380,480,1
"4274","3",74,"empathy",1988,360,160,520,1
"4275","3",75,"empathy",2167,300,240,540,0
"4276","3",76,"reciprocity",1714,360,160,520,1
"4277","3",77,"reciprocity",2508,340,180,520,0
"4278","3",78,"reciprocity",2158,320,220,540,1
"4279","3",79,"empathy",1519,280,280,560,0
"4280","3",80,"empathy",1956,380,20,400,0
"4281","3",81,"empathy",1344,380,60,440,0
"4282","3",82,"empathy",1250,360,120,480,0
"4283","3",83,"empathy",1573,220,320,540,0
"4285","4",1,"reciprocity",1062,300,240,540,1
"4286","4",2,"reciprocity",917,360,160,520,1
"4287","4",3,"reciprocity",1465,220,320,540,1
"4288","4",4,"empathy",1574,380,100,480,1
"4289","4",5,"empathy",854,220,320,540,1
"4290","4",6,"empathy",731,280,280,560,1
"4291","4",7,"empathy",1052,300,240,540,1
"4292","4",8,"empathy",969,40,380,420,1
"4295","4",11,"empathy",1875,380,40,420,1
"4296","4",12,"empathy",2717,20,380,400,1
"4297","4",13,"empathy",1215,240,300,540,1
"4298","4",14,"empathy",883,380,40,420,1
"4299","4",15,"empathy",906,180,340,520,1
"4300","4",16,"reciprocity",964,280,280,560,1
"4302","4",18,"reciprocity",858,20,380,400,1
"4304","4",20,"empathy",1066,380,100,480,1
"4305","4",21,"empathy",874,360,120,480,1
"4306","4",22,"reciprocity",2014,320,220,540,1
"4307","4",23,"reciprocity",882,380,100,480,1
"4308","4",24,"reciprocity",1600,280,280,560,1
"4309","4",25,"reciprocity",1413,380,100,480,1
"4310","4",26,"reciprocity",808,180,340,520,1
"4311","4",27,"reciprocity",1096,360,160,520,1
"4312","4",28,"reciprocity",786,240,300,540,1
"4313","4",29,"reciprocity",1094,240,300,540,1
"4314","4",30,"reciprocity",876,120,360,480,1
"4315","4",31,"reciprocity",867,320,220,540,1
"4316","4",32,"reciprocity",1603,360,120,480,1
"4317","4",33,"reciprocity",972,300,240,540,1
"4318","4",34,"reciprocity",987,160,360,520,1
"4319","4",35,"reciprocity",1751,380,40,420,1
"4320","4",36,"reciprocity",2351,380,40,420,1
"4321","4",37,"reciprocity",806,60,380,440,1
"4322","4",38,"reciprocity",1278,40,380,420,1
"4323","4",39,"reciprocity",1252,340,180,520,1
"4324","4",40,"reciprocity",868,360,120,480,1
"4326","4",42,"reciprocity",1317,380,60,440,1
"4328","4",44,"reciprocity",764,40,380,420,1
"4329","4",45,"reciprocity",2395,380,60,440,0
"4330","4",46,"empathy",2746,380,60,440,1
"4331","4",47,"empathy",836,320,220,540,1
"4332","4",48,"empathy",1682,360,160,520,1
"4333","4",49,"empathy",913,340,180,520,1
"4335","4",51,"empathy",1176,60,380,440,1
"4336","4",52,"reciprocity",2401,380,20,400,1
"4337","4",53,"reciprocity",956,380,20,400,1
"4338","4",54,"reciprocity",1548,180,340,520,1
"4339","4",55,"empathy",954,380,60,440,1
"4340","4",56,"empathy",769,240,300,540,1
"4341","4",57,"empathy",768,100,380,480,1
"4342","4",58,"empathy",1149,120,360,480,1
"4343","4",59,"empathy",900,220,320,540,1
"4344","4",60,"empathy",1012,360,120,480,1
"4345","4",61,"empathy",712,180,340,520,1
"4346","4",62,"empathy",1573,280,280,560,1
"4347","4",63,"empathy",676,40,380,420,1
"4348","4",64,"reciprocity",697,100,380,480,1
"4349","4",65,"reciprocity",800,100,380,480,1
"4350","4",66,"reciprocity",779,60,380,440,1
"4351","4",67,"empathy",660,120,360,480,1
"4352","4",68,"empathy",527,20,380,400,1
"4353","4",69,"empathy",1042,100,380,480,1
"4354","4",70,"reciprocity",767,220,320,540,1
"4355","4",71,"reciprocity",717,120,360,480,1
"4356","4",72,"reciprocity",735,160,360,520,1
"4357","4",73,"reciprocity",644,20,380,400,1
"4358","4",74,"reciprocity",736,340,180,520,1
"4360","4",76,"empathy",641,60,380,440,1
"4361","4",77,"empathy",988,360,160,520,1
"4363","4",79,"empathy",783,160,360,520,1
"4364","4",80,"empathy",2181,380,20,400,1
"4365","4",81,"empathy",876,340,180,520,1
"4366","4",82,"empathy",736,380,20,400,1
"4367","4",83,"empathy",706,300,240,540,1
"4368","4",84,"empathy",905,160,360,520,1
"4369","5",1,"reciprocity",1054,100,380,480,1
"4371","5",3,"reciprocity",951,40,380,420,1
"4372","5",4,"empathy",1306,180,340,520,1
"4374","5",6,"empathy",1309,220,320,540,1
"4376","5",8,"empathy",2107,380,20,400,0
"4377","5",9,"empathy",1824,360,160,520,1
"4378","5",10,"empathy",1352,380,100,480,1
"4379","5",11,"empathy",1774,380,40,420,0
"4380","5",12,"empathy",1792,320,220,540,1
"4381","5",13,"empathy",1804,360,160,520,1
"4382","5",14,"empathy",2235,380,40,420,0
"4383","5",15,"empathy",1159,60,380,440,1
"4384","5",16,"empathy",1046,180,340,520,1
"4385","5",17,"empathy",925,300,240,540,1
"4386","5",18,"empathy",787,220,320,540,1
"4388","5",20,"empathy",2404,380,100,480,1
"4389","5",21,"empathy",1601,280,280,560,1
"4390","5",22,"empathy",1948,380,20,400,0
"4392","5",24,"empathy",1151,340,180,520,1
"4393","5",25,"reciprocity",863,180,340,520,1
"4394","5",26,"reciprocity",1215,120,360,480,1
"4395","5",27,"reciprocity",789,280,280,560,1
"4396","5",28,"empathy",873,320,220,540,1
"4397","5",29,"empathy",873,160,360,520,1
"4398","5",30,"empathy",718,40,380,420,1
"4399","5",31,"reciprocity",1185,340,180,520,1
"4400","5",32,"reciprocity",1097,360,120,480,1
"4401","5",33,"reciprocity",1654,380,20,400,0
"4402","5",34,"empathy",882,20,380,400,1
"4403","5",35,"empathy",1117,280,280,560,1
"4404","5",36,"empathy",1061,40,380,420,1
"4405","5",37,"empathy",673,60,380,440,1
"4406","5",38,"empathy",950,20,380,400,1
"4407","5",39,"empathy",778,100,380,480,1
"4409","5",41,"reciprocity",770,120,360,480,1
"4410","5",42,"reciprocity",1228,60,380,440,1
"4411","5",43,"reciprocity",1869,380,100,480,1
"4413","5",45,"reciprocity",1137,280,280,560,1
"4414","5",46,"reciprocity",2081,380,40,420,0
"4415","5",47,"reciprocity",935,220,320,540,1
"4416","5",48,"reciprocity",1283,360,160,520,1
"4417","5",49,"reciprocity",733,20,380,400,1
"4418","5",50,"reciprocity",3467,380,60,440,0
"4419","5",51,"reciprocity",1041,220,320,540,1
"4421","5",53,"reciprocity",928,300,240,540,1
"4422","5",54,"reciprocity",812,160,360,520,1
"4423","5",55,"empathy",2125,380,60,440,0
"4424","5",56,"empathy",1488,360,120,480,1
"4425","5",57,"empathy",854,120,360,480,1
"4426","5",58,"reciprocity",913,40,380,420,1
"4427","5",59,"reciprocity",1744,380,100,480,1
"4428","5",60,"reciprocity",894,240,300,540,1
"4429","5",61,"empathy",882,160,360,520,1
"4430","5",62,"empathy",1087,340,180,520,1
"4431","5",63,"empathy",2313,380,60,440,0
"4432","5",64,"reciprocity",1064,320,220,540,1
"4433","5",65,"reciprocity",1377,240,300,540,1
"4434","5",66,"reciprocity",774,160,360,520,1
"4435","5",67,"empathy",879,300,240,540,1
"4436","5",68,"empathy",2085,360,120,480,1
"4437","5",69,"empathy",811,120,360,480,1
"4438","5",70,"empathy",824,100,380,480,1
"4439","5",71,"empathy",850,240,300,540,1
"4440","5",72,"empathy",1276,240,300,540,1
"4441","5",73,"reciprocity",1746,380,60,440,0
"4442","5",74,"reciprocity",1761,360,120,480,1
"4443","5",75,"reciprocity",1712,380,20,400,0
"4444","5",76,"reciprocity",1821,360,160,520,1
"4445","5",77,"reciprocity",826,60,380,440,1
"4446","5",78,"reciprocity",1647,320,220,540,1
"4447","5",79,"reciprocity",1419,20,380,400,1
"4448","5",80,"reciprocity",1186,340,180,520,1
"4449","5",81,"reciprocity",765,100,380,480,1
"4450","5",82,"reciprocity",2117,380,40,420,0
"4451","5",83,"reciprocity",1133,180,340,520,1
"4452","5",84,"reciprocity",1072,300,240,540,1
"4453","6",1,"empathy",2114,380,20,400,1
"4454","6",2,"empathy",1312,40,380,420,1
"4455","6",3,"empathy",1475,20,380,400,1
"4457","6",5,"empathy",1637,380,100,480,0
"4458","6",6,"empathy",1391,240,300,540,1
"4460","6",8,"empathy",2560,340,180,520,0
"4461","6",9,"empathy",1847,300,240,540,1
"4462","6",10,"empathy",1852,120,360,480,1
"4463","6",11,"empathy",1428,60,380,440,1
"4464","6",12,"empathy",1676,100,380,480,1
"4465","6",13,"empathy",1564,300,240,540,1
"4466","6",14,"empathy",2039,380,20,400,0
"4467","6",15,"empathy",2057,380,100,480,0
"4468","6",16,"reciprocity",1177,60,380,440,1
"4469","6",17,"reciprocity",1849,380,40,420,0
"4470","6",18,"reciprocity",2367,380,20,400,0
"4471","6",19,"reciprocity",1607,280,280,560,1
"4472","6",20,"reciprocity",2058,360,120,480,0
"4473","6",21,"reciprocity",1535,40,380,420,1
"4475","6",23,"reciprocity",1833,160,360,520,1
"4478","6",26,"reciprocity",2188,380,100,480,0
"4479","6",27,"reciprocity",1395,120,360,480,1
"4480","6",28,"empathy",1964,360,120,480,0
"4481","6",29,"empathy",1475,100,380,480,1
"4482","6",30,"empathy",1690,160,360,520,1
"4483","6",31,"reciprocity",1899,380,20,400,0
"4484","6",32,"reciprocity",1868,360,160,520,0
"4486","6",34,"reciprocity",1365,300,240,540,1
"4487","6",35,"reciprocity",1573,320,220,540,1
"4488","6",36,"reciprocity",2545,300,240,540,1
"4489","6",37,"empathy",1253,60,380,440,1
"4490","6",38,"empathy",1043,20,380,400,1
"4491","6",39,"empathy",2548,360,120,480,0
"4492","6",40,"empathy",1372,320,220,540,1
"4493","6",41,"empathy",2405,380,40,420,0
"4495","6",43,"reciprocity",1100,20,380,400,1
"4496","6",44,"reciprocity",1884,340,180,520,0
"4497","6",45,"reciprocity",1465,100,380,480,1
"4498","6",46,"reciprocity",1440,240,300,540,1
"4499","6",47,"reciprocity",1619,20,380,400,1
"4500","6",48,"reciprocity",1349,100,380,480,1
"4501","6",49,"reciprocity",1953,380,100,480,0
"4502","6",50,"reciprocity",1839,380,60,440,0
"4503","6",51,"reciprocity",1737,360,160,520,1
"4504","6",52,"empathy",2800,360,160,520,0
"4505","6",53,"empathy",923,180,340,520,1
"4506","6",54,"empathy",2186,380,60,440,1
"4507","6",55,"reciprocity",1405,220,320,540,1
"4508","6",56,"reciprocity",1121,180,340,520,1
"4509","6",57,"reciprocity",1545,240,300,540,1
"4510","6",58,"reciprocity",888,160,360,520,1
"4511","6",59,"reciprocity",1103,180,340,520,1
"4512","6",60,"reciprocity",2170,360,120,480,1
"4513","6",61,"empathy",1418,40,380,420,1
"4514","6",62,"empathy",1588,280,280,560,1
"4515","6",63,"empathy",937,220,320,540,1
"4516","6",64,"reciprocity",1072,220,320,540,1
"4517","6",65,"reciprocity",1268,120,360,480,1
"4518","6",66,"reciprocity",1315,60,380,440,1
"4519","6",67,"reciprocity",2000,320,220,540,0
"4520","6",68,"reciprocity",2518,380,60,440,0
"4521","6",69,"reciprocity",1783,380,40,420,0
"4522","6",70,"empathy",1121,160,360,520,1
"4523","6",71,"empathy",1716,380,40,420,0
"4525","6",73,"empathy",963,180,340,520,1
"4526","6",74,"empathy",869,280,280,560,1
"4527","6",75,"empathy",2637,340,180,520,0
"4528","6",76,"empathy",1359,120,360,480,1
"4529","6",77,"empathy",2080,320,220,540,0
"4530","6",78,"empathy",1397,240,300,540,1
"4531","6",79,"empathy",2349,360,160,520,1
"4532","6",80,"empathy",1924,220,320,540,1
"4533","6",81,"empathy",2461,380,60,440,0
"4534","6",82,"reciprocity",1006,40,380,420,1
"4535","6",83,"reciprocity",1666,280,280,560,1
"4536","6",84,"reciprocity",1296,340,180,520,1
"4537","7",1,"control",1219,380,60,440,0
"4538","7",2,"control",1511,60,380,440,1
"4539","7",3,"control",1751,380,40,420,0
"4540","7",4,"control",1469,380,20,400,0
"4542","7",6,"control",1613,380,20,400,0
"4543","7",7,"multi-motive",2044,360,120,480,1
"4544","7",8,"multi-motive",1787,120,360,480,1
"4545","7",9,"multi-motive",1859,20,380,400,1
"4547","7",11,"multi-motive",1896,280,280,560,1
"4548","7",12,"multi-motive",2028,380,40,420,0
"4549","7",13,"multi-motive",2975,280,280,560,1
"4550","7",14,"multi-motive",2304,360,160,520,0
"4551","7",15,"multi-motive",2416,380,40,420,0
"4552","7",16,"multi-motive",2125,240,300,540,1
"4553","7",17,"multi-motive",2270,360,120,480,0
"4554","7",18,"multi-motive",2160,100,380,480,1
"4555","7",19,"control",2263,320,220,540,0
"4556","7",20,"control",3108,160,360,520,1
"4558","7",22,"control",2555,280,280,560,0
"4559","7",23,"control",2099,20,380,400,1
"4560","7",24,"control",2070,360,160,520,0
"4561","7",25,"control",2145,380,60,440,0
"4562","7",26,"control",1701,300,240,540,1
"4563","7",27,"control",1937,300,240,540,0
"4564","7",28,"control",1917,180,340,520,1
"4565","7",29,"control",2123,360,120,480,0
"4566","7",30,"control",2497,280,280,560,1
"4567","7",31,"control",1666,40,380,420,1
"4568","7",32,"control",2630,340,180,520,0
"4571","7",35,"control",1690,100,380,480,1
"4573","7",37,"multi-motive",2402,300,240,540,0
"4574","7",38,"multi-motive",2224,180,340,520,1
"4575","7",39,"multi-motive",2153,380,20,400,0
"4576","7",40,"multi-motive",1641,300,240,540,1
"4577","7",41,"multi-motive",1983,380,20,400,0
"4578","7",42,"multi-motive",3293,380,100,480,1
"4579","7",43,"multi-motive",1956,40,380,420,1
"4580","7",44,"multi-motive",1907,100,380,480,1
"4581","7",45,"multi-motive",3167,220,320,540,0
"4582","7",46,"control",2700,180,340,520,1
"4583","7",47,"control",1564,380,40,420,0
"4584","7",48,"control",1503,60,380,440,1
"4585","7",49,"control",1541,380,100,480,1
"4586","7",50,"control",2114,360,120,480,0
"4587","7",51,"control",1901,240,300,540,1
"4588","7",52,"control",1694,220,320,540,1
"4589","7",53,"control",2463,100,380,480,1
"4590","7",54,"control",1578,120,360,480,1
"4591","7",55,"control",1270,40,380,420,1
"4592","7",56,"control",2176,220,320,540,0
"4593","7",57,"control",1862,240,300,540,1
"4594","7",58,"multi-motive",2483,380,60,440,0
"4595","7",59,"multi-motive",1981,20,380,400,1
"4596","7",60,"multi-motive",2656,380,100,480,0
"4598","7",62,"multi-motive",1715,340,180,520,0
"4599","7",63,"multi-motive",1596,160,360,520,1
"4600","7",64,"multi-motive",2055,180,340,520,1
"4601","7",65,"multi-motive",1577,60,380,440,1
"4602","7",66,"multi-motive",1668,60,380,440,1
"4603","7",67,"control",1701,120,360,480,1
"4604","7",68,"control",2142,20,380,400,1
"4605","7",69,"control",2055,340,180,520,0
"4606","7",70,"control",2025,320,220,540,1
"4607","7",71,"control",2454,360,160,520,0
"4608","7",72,"control",1522,160,360,520,1
"4609","7",73,"multi-motive",1912,360,160,520,0
"4610","7",74,"multi-motive",2334,340,180,520,0
"4611","7",75,"multi-motive",1975,40,380,420,1
"4612","7",76,"multi-motive",1530,120,360,480,1
"4613","7",77,"multi-motive",1438,240,300,540,1
"4614","7",78,"multi-motive",1806,320,220,540,0
"4616","7",80,"multi-motive",1748,160,360,520,1
"4617","7",81,"multi-motive",1483,220,320,540,1
"4618","7",82,"multi-motive",2447,320,220,540,1
"4620","7",84,"multi-motive",1900,380,60,440,0
"4621","8",1,"multi-motive",951,120,360,480,1
"4622","8",2,"multi-motive",901,40,380,420,1
"4623","8",3,"multi-motive",1465,220,320,540,1
"4624","8",4,"multi-motive",851,60,380,440,1
"4625","8",5,"multi-motive",2091,360,120,480,0
"4626","8",6,"multi-motive",962,60,380,440,1
"4627","8",7,"control",883,280,280,560,1
"4628","8",8,"control",2001,320,220,540,0
"4629","8",9,"control",1130,320,220,540,1
"4630","8",10,"control",2279,280,280,560,0
"4631","8",11,"control",2491,360,120,480,1
"4632","8",12,"control",706,60,380,440,1
"4634","8",14,"control",801,120,360,480,1
"4635","8",15,"control",1391,380,100,480,1
"4636","8",16,"multi-motive",1154,220,320,540,1
"4637","8",17,"multi-motive",1172,40,380,420,1
"4638","8",18,"multi-motive",1638,380,20,400,0
"4640","8",20,"multi-motive",1219,100,380,480,1
"4641","8",21,"multi-motive",1288,240,300,540,1
"4643","8",23,"control",871,20,380,400,1
"4644","8",24,"control",1576,120,360,480,1
"4645","8",25,"control",1240,180,340,520,1
"4646","8",26,"control",1779,300,240,540,0
"4647","8",27,"control",1390,360,160,520,1
"4648","8",28,"control",1763,180,340,520,1
"4649","8",29,"control",1113,20,380,400,1
"4650","8",30,"control",1165,220,320,540,1
"4651","8",31,"control",1322,40,380,420,1
"4652","8",32,"control",1298,300,240,540,1
"4653","8",33,"control",1319,220,320,540,1
"4654","8",34,"multi-motive",2396,320,220,540,1
"4656","8",36,"multi-motive",1034,180,340,520,1
"4658","8",38,"multi-motive",1390,300,240,540,1
"4659","8",39,"multi-motive",1172,380,60,440,0
"4660","8",40,"multi-motive",1120,380,100,480,0
"4661","8",41,"multi-motive",2199,180,340,520,1
"4662","8",42,"multi-motive",1282,120,360,480,1
"4663","8",43,"control",1289,380,100,480,0
"4664","8",44,"control",1859,380,20,400,0
"4665","8",45,"control",2312,160,360,520,1
"4666","8",46,"multi-motive",2243,340,180,520,0
"4667","8",47,"multi-motive",1659,380,20,400,0
"4668","8",48,"multi-motive",992,160,360,520,1
"4669","8",49,"multi-motive",724,20,380,400,1
"4670","8",50,"multi-motive",1727,360,120,480,0
"4671","8",51,"multi-motive",1469,380,60,440,0
"4672","8",52,"control",2055,60,380,440,0
"4674","8",54,"control",2140,340,180,520,0
"4675","8",55,"control",1877,340,180,520,0
"4677","8",57,"control",1005,240,300,540,1
"4679","8",59,"multi-motive",1946,380,100,480,0
"4680","8",60,"multi-motive",1474,280,280,560,1
"4681","8",61,"control",1831,360,120,480,0
"4682","8",62,"control",982,160,360,520,1
"4683","8",63,"control",1299,380,40,420,0
"4684","8",64,"control",1638,380,20,400,0
"4685","8",65,"control",1342,40,380,420,1
"4686","8",66,"control",1801,240,300,540,1
"4687","8",67,"control",1871,360,160,520,0
"4688","8",68,"control",1696,380,40,420,0
"4689","8",69,"control",945,100,380,480,1
"4690","8",70,"multi-motive",1885,380,40,420,0
"4691","8",71,"multi-motive",1486,340,180,520,0
"4692","8",72,"multi-motive",1816,100,380,480,1
"4693","8",73,"control",2534,380,60,440,0
"4694","8",74,"control",872,100,380,480,1
"4695","8",75,"control",1373,380,60,440,0
"4696","8",76,"multi-motive",2379,320,220,540,0
"4697","8",77,"multi-motive",1455,280,280,560,1
"4698","8",78,"multi-motive",1972,240,300,540,1
"4699","8",79,"multi-motive",1501,380,40,420,0
"4700","8",80,"multi-motive",2080,160,360,520,1
"4701","8",81,"multi-motive",2335,360,160,520,0
"4702","8",82,"multi-motive",1345,360,160,520,0
"4703","8",83,"multi-motive",903,20,380,400,1
"4704","8",84,"multi-motive",1268,300,240,540,0
"4705","9",1,"multi-motive",1510,120,360,480,1
"4707","9",3,"multi-motive",2604,340,180,520,0
"4708","9",4,"multi-motive",981,60,380,440,1
"4709","9",5,"multi-motive",1054,160,360,520,1
"4710","9",6,"multi-motive",2315,380,40,420,0
"4711","9",7,"multi-motive",1643,380,100,480,1
"4712","9",8,"multi-motive",2224,360,120,480,1
"4713","9",9,"multi-motive",2509,380,60,440,0
"4715","9",11,"control",1165,300,240,540,1
"4716","9",12,"control",968,240,300,540,1
"4717","9",13,"control",1378,340,180,520,1
"4718","9",14,"control",1854,20,380,400,1
"4720","9",16,"control",1888,360,120,480,0
"4721","9",17,"control",1492,100,380,480,1
"4722","9",18,"control",1110,280,280,560,1
"4723","9",19,"multi-motive",920,280,280,560,1
"4724","9",20,"multi-motive",1667,360,160,520,1
"4725","9",21,"multi-motive",1971,300,240,540,1
"4726","9",22,"control",2654,360,120,480,0
"4727","9",23,"control",2390,380,20,400,0
"4728","9",24,"control",3696,380,100,480,0
"4729","9",25,"control",969,120,360,480,1
"4730","9",26,"control",1062,280,280,560,1
"4731","9",27,"control",889,20,380,400,1
"4732","9",28,"control",984,160,360,520,1
"4733","9",29,"control",2343,380,20,400,0
"4734","9",30,"control",3027,360,160,520,1
"4735","9",31,"multi-motive",1313,280,280,560,1
"4736","9",32,"multi-motive",1294,40,380,420,1
"4737","9",33,"multi-motive",990,180,340,520,1
"4738","9",34,"control",855,180,340,520,1
"4739","9",35,"control",701,60,380,440,1
"4740","9",36,"control",2521,380,40,420,0
"4741","9",37,"control",1289,300,240,540,1
"4742","9",38,"control",829,40,380,420,1
"4743","9",39,"control",740,160,360,520,1
"4744","9",40,"multi-motive",2295,240,300,540,1
"4745","9",41,"multi-motive",1997,100,380,480,1
"4746","9",42,"multi-motive",2714,380,60,440,0
"4747","9",43,"control",3538,380,60,440,1
"4749","9",45,"control",1805,380,100,480,0
"4750","9",46,"control",2039,120,360,480,1
"4751","9",47,"control",3380,380,60,440,1
"4752","9",48,"control",1151,100,380,480,1
"4753","9",49,"multi-motive",907,20,380,400,1
"4754","9",50,"multi-motive",3078,320,220,540,1
"4755","9",51,"multi-motive",2882,380,100,480,0
"4756","9",52,"control",878,220,320,540,1
"4757","9",53,"control",817,60,380,440,1
"4758","9",54,"control",865,180,340,520,1
"4760","9",56,"control",1955,340,180,520,1
"4761","9",57,"control",2950,240,300,540,1
"4762","9",58,"multi-motive",2429,360,120,480,0
"4763","9",59,"multi-motive",804,340,180,520,1
"4764","9",60,"multi-motive",873,20,380,400,1
"4765","9",61,"multi-motive",1141,160,360,520,1
"4766","9",62,"multi-motive",876,240,300,540,1
"4767","9",63,"multi-motive",836,40,380,420,1
"4768","9",64,"multi-motive",988,120,360,480,1
"4769","9",65,"multi-motive",813,300,240,540,1
"4770","9",66,"multi-motive",981,220,320,540,1
"4772","9",68,"multi-motive",1981,380,20,400,0
"4774","9",70,"control",993,220,320,540,1
"4775","9",71,"control",1007,40,380,420,1
"4776","9",72,"control",580,320,220,540,1
"4778","9",74,"multi-motive",2217,380,40,420,0
"4779","9",75,"multi-motive",1671,320,220,540,1
"4780","9",76,"multi-motive",642,60,380,440,1
"4781","9",77,"multi-motive",864,100,380,480,1
"4782","9",78,"multi-motive",756,220,320,540,1
"4783","9",79,"multi-motive",2659,380,20,400,0
"4784","9",80,"multi-motive",974,360,160,520,1
"4785","9",81,"multi-motive",886,180,340,520,1
"4786","9",82,"control",1121,320,220,540,1
"4787","9",83,"control",2307,380,40,420,0
"4788","9",84,"control",1226,360,160,520,1
"4789","10",1,"control",1065,40,380,420,1
"4790","10",2,"control",1124,40,380,420,1
"4791","10",3,"control",1098,220,320,540,1
"4792","10",4,"control",2050,380,20,400,0
"4793","10",5,"control",1297,240,300,540,1
"4794","10",6,"control",1097,160,360,520,1
"4795","10",7,"multi-motive",1445,340,180,520,1
"4796","10",8,"multi-motive",1337,360,160,520,1
"4797","10",9,"multi-motive",2911,280,280,560,0
"4798","10",10,"control",2229,220,320,540,1
"4799","10",11,"control",2429,380,40,420,0
"4800","10",12,"control",1630,100,380,480,1
"4802","10",14,"multi-motive",1774,340,180,520,1
"4803","10",15,"multi-motive",2843,380,20,400,0
"4804","10",16,"control",1246,180,340,520,1
"4805","10",17,"control",998,300,240,540,1
"4806","10",18,"control",1720,380,100,480,1
"4807","10",19,"multi-motive",984,320,220,540,1
"4809","10",21,"multi-motive",1692,20,380,400,1
"4810","10",22,"control",2959,340,180,520,1
"4811","10",23,"control",2232,240,300,540,1
"4813","10",25,"multi-motive",1118,360,120,480,1
"4814","10",26,"multi-motive",1397,380,100,480,1
"4815","10",27,"multi-motive",1657,20,380,400,1
"4816","10",28,"control",2130,300,240,540,1
"4817","10",29,"control",988,20,380,400,1
"4818","10",30,"control",2716,380,60,440,0
"4819","10",31,"control",1068,100,380,480,1
"4820","10",32,"control",1020,380,60,440,1
"4821","10",33,"control",783,60,380,440,1
"4822","10",34,"control",3307,360,120,480,0
"4823","10",35,"control",1393,120,360,480,1
"4824","10",36,"control",2868,380,20,400,0
"4825","10",37,"multi-motive",901,120,360,480,1
"4826","10",38,"multi-motive",1786,380,60,440,1
"4827","10",39,"multi-motive",1141,40,380,420,1
"4828","10",40,"multi-motive",1409,60,380,440,1
"4829","10",41,"multi-motive",3625,380,60,440,0
"4830","10",42,"multi-motive",865,160,360,520,1
"4831","10",43,"multi-motive",918,180,340,520,1
"4832","10",44,"multi-motive",2875,360,120,480,1
"4833","10",45,"multi-motive",2762,380,100,480,1
"4834","10",46,"multi-motive",1321,220,320,540,1
"4835","10",47,"multi-motive",1084,280,280,560,1
"4836","10",48,"multi-motive",1021,120,360,480,1
"4837","10",49,"multi-motive",1801,60,380,440,1
"4838","10",50,"multi-motive",1203,320,220,540,1
"4839","10",51,"multi-motive",1156,100,380,480,1
"4840","10",52,"control",2641,180,340,520,0
"4841","10",53,"control",1514,120,360,480,1
"4842","10",54,"control",1913,360,160,520,1
"4843","10",55,"control",1617,380,40,420,1
"4844","10",56,"control",2428,360,160,520,1
"4845","10",57,"control",1411,280,280,560,1
"4846","10",58,"multi-motive",2670,360,160,520,1
"4848","10",60,"multi-motive",1517,380,40,420,1
"4849","10",61,"control",1684,360,120,480,1
"4851","10",63,"control",922,20,380,400,1
"4852","10",64,"multi-motive",2342,380,40,420,0
"4854","10",66,"multi-motive",2332,380,20,400,0
"4855","10",67,"control",2099,380,100,480,1
"4856","10",68,"control",1222,160,360,520,1
"4857","10",69,"control",1267,280,280,560,1
"4858","10",70,"multi-motive",1363,240,300,540,1
"4859","10",71,"multi-motive",993,100,380,480,1
"4860","10",72,"multi-motive",920,240,300,540,1
"4861","10",73,"multi-motive",1105,160,360,520,1
"4862","10",74,"multi-motive",1238,40,380,420,1
"4863","10",75,"multi-motive",1592,180,340,520,1
"4864","10",76,"control",1778,60,380,440,1
"4865","10",77,"control",1508,320,220,540,1
"4866","10",78,"control",1898,320,220,540,1
"4867","10",79,"control",1885,340,180,520,1
"4870","10",82,"multi-motive",783,300,240,540,1
"4871","10",83,"multi-motive",1042,300,240,540,1
"4872","10",84,"multi-motive",808,220,320,540,1
"4873","11",1,"reciprocity",2311,380,60,440,0
"4874","11",2,"reciprocity",1487,280,280,560,0
"4875","11",3,"reciprocity",1367,60,380,440,0
"4876","11",4,"reciprocity",2009,380,40,420,0
"4877","11",5,"reciprocity",1472,160,360,520,1
"4878","11",6,"reciprocity",1408,340,180,520,0
"4879","11",7,"empathy",1520,320,220,540,1
"4881","11",9,"empathy",1365,380,40,420,0
"4882","11",10,"empathy",1292,340,180,520,0
"4883","11",11,"empathy",1140,240,300,540,0
"4884","11",12,"empathy",1719,380,40,420,1
"4885","11",13,"empathy",1813,280,280,560,1
"4886","11",14,"empathy",2290,100,380,480,1
"4887","11",15,"empathy",3022,20,380,400,1
"4888","11",16,"empathy",1953,120,360,480,1
"4889","11",17,"empathy",1901,380,20,400,0
"4890","11",18,"empathy",1922,300,240,540,1
"4891","11",19,"reciprocity",1862,100,380,480,1
"4892","11",20,"reciprocity",1714,20,380,400,1
"4893","11",21,"reciprocity",1627,360,120,480,0
"4894","11",22,"empathy",1753,60,380,440,1
"4895","11",23,"empathy",1255,320,220,540,0
"4896","11",24,"empathy",2245,240,300,540,1
"4897","11",25,"reciprocity",2242,40,380,420,1
"4898","11",26,"reciprocity",1488,380,100,480,0
"4899","11",27,"reciprocity",2206,240,300,540,1
"4900","11",28,"empathy",1500,380,60,440,0
"4901","11",29,"empathy",1430,380,20,400,0
"4902","11",30,"empathy",814,360,160,520,0
"4903","11",31,"empathy",1347,220,320,540,1
"4905","11",33,"empathy",1765,160,360,520,1
"4906","11",34,"empathy",1280,380,60,440,0
"4907","11",35,"empathy",1567,380,100,480,0
"4908","11",36,"empathy",1413,300,240,540,0
"4909","11",37,"reciprocity",2394,360,120,480,0
"4911","11",39,"reciprocity",2427,120,360,480,0
"4912","11",40,"reciprocity",1983,240,300,540,1
"4913","11",41,"reciprocity",2707,160,360,520,0
"4914","11",42,"reciprocity",1795,40,380,420,1
"4915","11",43,"empathy",1160,360,120,480,0
"4916","11",44,"empathy",1307,360,160,520,0
"4917","11",45,"empathy",1658,180,340,520,1
"4918","11",46,"empathy",1974,280,280,560,0
"4920","11",48,"empathy",1235,380,100,480,0
"4921","11",49,"empathy",1524,20,380,400,1
"4922","11",50,"empathy",1949,180,340,520,0
"4923","11",51,"empathy",1330,100,380,480,1
"4924","11",52,"reciprocity",1381,320,220,540,0
"4925","11",53,"reciprocity",1473,120,360,480,1
"4926","11",54,"reciprocity",1860,320,220,540,0
"4927","11",55,"empathy",2234,40,380,420,1
"4928","11",56,"empathy",1598,60,380,440,1
"4929","11",57,"empathy",1099,40,380,420,1
"4930","11",58,"reciprocity",1517,380,60,440,0
"4931","11",59,"reciprocity",939,340,180,520,0
"4932","11",60,"reciprocity",1227,60,380,440,1
"4934","11",62,"empathy",2233,340,180,520,0
"4935","11",63,"empathy",1648,360,120,480,1
"4937","11",65,"reciprocity",1875,100,380,480,1
"4938","11",66,"reciprocity",1672,360,160,520,0
"4939","11",67,"reciprocity",1471,180,340,520,1
"4941","11",69,"reciprocity",1159,360,160,520,0
"4942","11",70,"empathy",2006,160,360,520,1
"4943","11",71,"empathy",1307,120,360,480,1
"4944","11",72,"empathy",1312,220,320,540,0
"4945","11",73,"reciprocity",2138,220,320,540,0
"4946","11",74,"reciprocity",1267,300,240,540,0
"4947","11",75,"reciprocity",1551,300,240,540,1
"4949","11",77,"reciprocity",1203,380,20,400,0
"4950","11",78,"reciprocity",1337,20,380,400,1
"4951","11",79,"reciprocity",1310,380,40,420,0
"4952","11",80,"reciprocity",2078,380,100,480,0
"4953","11",81,"reciprocity",1513,280,280,560,1
"4954","11",82,"reciprocity",1266,220,320,540,1
"4955","11",83,"reciprocity",1835,180,340,520,1
"4956","11",84,"reciprocity",1806,380,20,400,0
"5127","12",3,"reciprocity",2367,300,240,540,0
"5128","12",4,"empathy",2153,160,360,520,1
"5129","12",5,"empathy",2188,380,60,440,0
"5130","12",6,"empathy",3642,120,360,480,1
"5131","12",7,"reciprocity",2996,360,160,520,0
"5132","12",8,"reciprocity",1709,220,320,540,1
"5133","12",9,"reciprocity",2321,380,100,480,0
"5134","12",10,"reciprocity",2451,360,160,520,0
"5135","12",11,"reciprocity",2709,280,280,560,0
"5136","12",12,"reciprocity",1889,180,340,520,1
"5137","12",13,"reciprocity",3192,20,380,400,1
"5138","12",14,"reciprocity",2251,320,220,540,0
"5139","12",15,"reciprocity",1910,240,300,540,1
"5141","12",17,"reciprocity",1752,300,240,540,0
"5143","12",19,"reciprocity",1349,60,380,440,1
"5144","12",20,"reciprocity",1168,20,380,400,1
"5145","12",21,"reciprocity",3123,380,20,400,0
"5146","12",22,"reciprocity",2372,360,120,480,1
"5147","12",23,"reciprocity",3623,40,380,420,1
"5148","12",24,"reciprocity",1480,380,100,480,0
"5149","12",25,"empathy",1862,300,240,540,1
"5150","12",26,"empathy",2908,280,280,560,0
"5151","12",27,"empathy",1904,240,300,540,0
"5152","12",28,"empathy",2271,380,100,480,0
"5153","12",29,"empathy",2612,380,60,440,0
"5155","12",31,"empathy",3790,380,40,420,0
"5156","12",32,"empathy",2075,360,120,480,1
"5157","12",33,"empathy",1858,340,180,520,0
"5158","12",34,"empathy",3475,60,380,440,1
"5159","12",35,"empathy",2518,280,280,560,1
"5160","12",36,"empathy",2359,220,320,540,1
"5161","12",37,"reciprocity",1608,120,360,480,1
"5162","12",38,"reciprocity",3698,380,40,420,1
"5163","12",39,"reciprocity",3413,100,380,480,0
"5164","12",40,"reciprocity",3642,60,380,440,1
"5165","12",41,"reciprocity",1206,100,380,480,1
"5166","12",42,"reciprocity",1699,360,120,480,0
"5168","12",44,"empathy",2387,180,340,520,0
"5169","12",45,"empathy",1794,180,340,520,1
"5170","12",46,"reciprocity",2582,320,220,540,1
"5171","12",47,"reciprocity",1648,220,320,540,0
"5172","12",48,"reciprocity",3189,160,360,520,1
"5173","12",49,"empathy",2110,20,380,400,1
"5175","12",51,"empathy",2209,360,120,480,0
"5177","12",53,"empathy",1764,120,360,480,1
"5178","12",54,"empathy",1227,240,300,540,1
"5179","12",55,"empathy",1684,340,180,520,1
"5180","12",56,"empathy",1916,320,220,540,0
"5181","12",57,"empathy",1984,380,100,480,1
"5182","12",58,"empathy",2716,380,40,420,0
"5183","12",59,"empathy",2930,320,220,540,1
"5184","12",60,"empathy",2385,220,320,540,0
"5185","12",61,"empathy",2681,100,380,480,0
"5187","12",63,"empathy",1929,360,160,520,0
"5188","12",64,"empathy",2259,300,240,540,0
"5189","12",65,"empathy",2571,360,160,520,1
"5190","12",66,"empathy",2860,380,20,400,0
"5191","12",67,"empathy",1453,20,380,400,1
"5192","12",68,"empathy",2361,160,360,520,0
"5193","12",69,"empathy",1939,60,380,440,1
"5194","12",70,"reciprocity",2255,340,180,520,1
"5195","12",71,"reciprocity",2276,180,340,520,0
"5197","12",73,"empathy",2806,40,380,420,1
"5198","12",74,"empathy",1101,40,380,420,1
"5199","12",75,"empathy",1429,100,380,480,1
"5200","12",76,"reciprocity",1879,280,280,560,1
"5201","12",77,"reciprocity",2568,380,60,440,1
"5202","12",78,"reciprocity",1497,120,360,480,0
"5203","12",79,"reciprocity",2482,340,180,520,0
"5204","12",80,"reciprocity",1724,160,360,520,1
"5205","12",81,"reciprocity",1450,40,380,420,1
"5206","12",82,"reciprocity",1793,380,20,400,0
"5207","12",83,"reciprocity",1719,240,300,540,0
"5209","13",1,"empathy",1763,240,300,540,1
"5210","13",2,"empathy",1469,360,120,480,1
"5213","13",5,"empathy",1250,220,320,540,1
"5214","13",6,"empathy",1571,380,100,480,1
"5215","13",7,"reciprocity",926,160,360,520,1
"5216","13",8,"reciprocity",864,60,380,440,1
"5217","13",9,"reciprocity",1101,240,300,540,1
"5219","13",11,"reciprocity",1071,100,380,480,1
"5220","13",12,"reciprocity",1440,360,160,520,1
"5221","13",13,"reciprocity",1069,40,380,420,1
"5222","13",14,"reciprocity",1201,180,340,520,1
"5223","13",15,"reciprocity",1782,340,180,520,1
"5224","13",16,"reciprocity",1175,20,380,400,1
"5225","13",17,"reciprocity",906,360,120,480,1
"5226","13",18,"reciprocity",1312,280,280,560,1
"5227","13",19,"reciprocity",1333,120,360,480,1
"5228","13",20,"reciprocity",1106,180,340,520,1
"5229","13",21,"reciprocity",1573,380,100,480,1
"5230","13",22,"reciprocity",1165,320,220,540,1
"5231","13",23,"reciprocity",1212,340,180,520,1
"5233","13",25,"empathy",1040,280,280,560,1
"5234","13",26,"empathy",2069,300,240,540,1
"5235","13",27,"empathy",1356,360,160,520,1
"5236","13",28,"empathy",782,40,380,420,1
"5237","13",29,"empathy",1313,380,40,420,1
"5238","13",30,"empathy",972,380,60,440,1
"5239","13",31,"empathy",1272,360,120,480,1
"5240","13",32,"empathy",1233,380,100,480,1
"5241","13",33,"empathy",852,20,380,400,1
"5242","13",34,"reciprocity",922,380,60,440,1
"5243","13",35,"reciprocity",976,280,280,560,1
"5244","13",36,"reciprocity",742,40,380,420,1
"5245","13",37,"empathy",1632,220,320,540,1
"5246","13",38,"empathy",1763,60,380,440,1
"5247","13",39,"empathy",921,160,360,520,1
"5248","13",40,"reciprocity",821,120,360,480,1
"5249","13",41,"reciprocity",920,60,380,440,1
"5250","13",42,"reciprocity",1108,300,240,540,1
"5251","13",43,"empathy",1830,380,20,400,1
"5252","13",44,"empathy",1201,280,280,560,1
"5253","13",45,"empathy",924,120,360,480,1
"5254","13",46,"empathy",1009,340,180,520,1
"5255","13",47,"empathy",1004,120,360,480,1
"5256","13",48,"empathy",1816,320,220,540,1
"5257","13",49,"reciprocity",1246,360,160,520,1
"5258","13",50,"reciprocity",1101,220,320,540,1
"5259","13",51,"reciprocity",1137,380,20,400,1
"5260","13",52,"empathy",1319,20,380,400,1
"5262","13",54,"empathy",1155,240,300,540,1
"5263","13",55,"reciprocity",1028,320,220,540,1
"5264","13",56,"reciprocity",1153,160,360,520,1
"5266","13",58,"empathy",2038,340,180,520,1
"5267","13",59,"empathy",1233,360,160,520,1
"5268","13",60,"empathy",1317,180,340,520,1
"5269","13",61,"reciprocity",1673,380,20,400,1
"5270","13",62,"reciprocity",842,240,300,540,1
"5271","13",63,"reciprocity",808,20,380,400,1
"5272","13",64,"empathy",1302,380,20,400,1
"5273","13",65,"empathy",983,40,380,420,1
"5275","13",67,"reciprocity",1056,360,120,480,1
"5276","13",68,"reciprocity",650,100,380,480,1
"5277","13",69,"reciprocity",927,380,40,420,1
"5278","13",70,"empathy",910,160,360,520,1
"5279","13",71,"empathy",1166,380,40,420,1
"5280","13",72,"empathy",1152,180,340,520,1
"5281","13",73,"empathy",936,320,220,540,1
"5282","13",74,"empathy",1509,60,380,440,1
"5283","13",75,"empathy",899,100,380,480,1
"5284","13",76,"reciprocity",1097,380,60,440,1
"5286","13",78,"reciprocity",835,300,240,540,1
"5287","13",79,"empathy",1014,300,240,540,1
"5288","13",80,"empathy",934,100,380,480,1
"5289","13",81,"empathy",1074,380,60,440,1
"5290","13",82,"reciprocity",1010,380,100,480,1
"5291","13",83,"reciprocity",1156,220,320,540,1
"5292","13",84,"reciprocity",1160,380,40,420,1
"5293","14",1,"reciprocity",1736,380,60,440,1
"5294","14",2,"reciprocity",2248,340,180,520,1
"5295","14",3,"reciprocity",3189,180,340,520,0
"5296","14",4,"empathy",925,280,280,560,1
"5297","14",5,"empathy",1959,380,40,420,1
"5298","14",6,"empathy",1032,380,60,440,1
"5299","14",7,"empathy",986,340,180,520,1
"5300","14",8,"empathy",2168,380,100,480,1
"5301","14",9,"empathy",1122,320,220,540,1
"5302","14",10,"empathy",1157,100,380,480,1
"5303","14",11,"empathy",872,60,380,440,1
"5305","14",13,"empathy",1502,60,380,440,1
"5306","14",14,"empathy",1406,360,120,480,1
"5307","14",15,"empathy",2119,360,160,520,1
"5308","14",16,"empathy",1571,360,120,480,1
"5309","14",17,"empathy",1380,160,360,520,1
"5311","14",19,"empathy",1282,240,300,540,1
"5313","14",21,"empathy",1457,20,380,400,1
"5314","14",22,"reciprocity",2150,240,300,540,1
"5315","14",23,"reciprocity",3312,360,160,520,0
"5316","14",24,"reciprocity",1851,340,180,520,0
"5317","14",25,"reciprocity",2027,360,120,480,1
"5318","14",26,"reciprocity",2298,380,60,440,1
"5320","14",28,"empathy",2416,40,380,420,1
"5321","14",29,"empathy",1113,320,220,540,1
"5322","14",30,"empathy",1538,300,240,540,1
"5323","14",31,"reciprocity",2114,160,360,520,0
"5324","14",32,"reciprocity",3089,380,40,420,0
"5325","14",33,"reciprocity",1754,300,240,540,1
"5326","14",34,"empathy",3628,380,20,400,1
"5327","14",35,"empathy",801,20,380,400,1
"5328","14",36,"empathy",1616,380,20,400,1
"5329","14",37,"reciprocity",1953,320,220,540,0
"5330","14",38,"reciprocity",3038,100,380,480,0
"5332","14",40,"reciprocity",1391,60,380,440,1
"5333","14",41,"reciprocity",2215,40,380,420,0
"5334","14",42,"reciprocity",2657,280,280,560,1
"5335","14",43,"reciprocity",2306,360,120,480,0
"5336","14",44,"reciprocity",2564,180,340,520,1
"5337","14",45,"reciprocity",2974,380,20,400,0
"5338","14",46,"empathy",1384,240,300,540,1
"5339","14",47,"empathy",1412,380,40,420,1
"5340","14",48,"empathy",2254,220,320,540,1
"5341","14",49,"reciprocity",2385,220,320,540,0
"5343","14",51,"reciprocity",1719,380,100,480,0
"5344","14",52,"reciprocity",1695,40,380,420,1
"5346","14",54,"reciprocity",1746,300,240,540,0
"5347","14",55,"empathy",1167,360,160,520,1
"5348","14",56,"empathy",1372,380,60,440,1
"5349","14",57,"empathy",1258,280,280,560,1
"5350","14",58,"reciprocity",2450,320,220,540,1
"5352","14",60,"reciprocity",1186,20,380,400,1
"5353","14",61,"reciprocity",2437,160,360,520,0
"5354","14",62,"reciprocity",3689,380,100,480,1
"5355","14",63,"reciprocity",918,100,380,480,1
"5356","14",64,"empathy",1300,180,340,520,1
"5357","14",65,"empathy",1208,380,100,480,1
"5359","14",67,"reciprocity",2818,120,360,480,1
"5360","14",68,"reciprocity",3534,360,160,520,1
"5361","14",69,"reciprocity",2026,240,300,540,0
"5362","14",70,"reciprocity",3722,60,380,440,0
"5363","14",71,"reciprocity",2457,20,380,400,0
"5365","14",73,"empathy",1432,100,380,480,1
"5366","14",74,"empathy",1632,160,360,520,1
"5367","14",75,"empathy",1478,120,360,480,1
"5368","14",76,"empathy",1371,300,240,540,1
"5369","14",77,"empathy",1228,120,360,480,1
"5370","14",78,"empathy",1203,220,320,540,1
"5371","14",79,"reciprocity",2494,280,280,560,0
"5372","14",80,"reciprocity",2670,380,40,420,1
"5373","14",81,"reciprocity",2117,220,320,540,1
"5374","14",82,"empathy",1136,40,380,420,1
"5375","14",83,"empathy",1557,340,180,520,1
"5376","14",84,"empathy",1816,180,340,520,1
"5377","15",1,"reciprocity",1357,360,160,520,0
"5378","15",2,"reciprocity",958,20,380,400,1
"5379","15",3,"reciprocity",2041,380,20,400,0
"5380","15",4,"empathy",752,20,380,400,1
"5381","15",5,"empathy",813,40,380,420,1
"5382","15",6,"empathy",1436,340,180,520,1
"5383","15",7,"reciprocity",798,160,360,520,1
"5384","15",8,"reciprocity",768,180,340,520,1
"5385","15",9,"reciprocity",1239,340,180,520,1
"5386","15",10,"empathy",1326,320,220,540,1
"5387","15",11,"empathy",1802,380,20,400,0
"5388","15",12,"empathy",1254,180,340,520,1
"5390","15",14,"empathy",1201,160,360,520,1
"5391","15",15,"empathy",1347,300,240,540,1
"5392","15",16,"reciprocity",1797,380,40,420,1
"5393","15",17,"reciprocity",2165,360,120,480,1
"5394","15",18,"reciprocity",1231,280,280,560,1
"5395","15",19,"empathy",1029,320,220,540,1
"5396","15",20,"empathy",1959,380,40,420,0
"5397","15",21,"empathy",997,280,280,560,1
"5398","15",22,"reciprocity",1839,380,100,480,0
"5400","15",24,"reciprocity",1218,220,320,540,1
"5401","15",25,"reciprocity",1429,60,380,440,1
"5402","15",26,"reciprocity",1749,40,380,420,1
"5404","15",28,"empathy",1150,360,160,520,1
"5405","15",29,"empathy",1610,380,100,480,1
"5406","15",30,"empathy",1557,360,120,480,1
"5407","15",31,"empathy",1152,240,300,540,1
"5408","15",32,"empathy",1518,380,20,400,1
"5409","15",33,"empathy",1196,220,320,540,1
"5410","15",34,"reciprocity",1560,120,360,480,1
"5411","15",35,"reciprocity",807,40,380,420,1
"5412","15",36,"reciprocity",1550,360,160,520,1
"5414","15",38,"empathy",1116,220,320,540,1
"5415","15",39,"empathy",1054,100,380,480,1
"5416","15",40,"empathy",1195,180,340,520,1
"5417","15",41,"empathy",1871,380,60,440,1
"5418","15",42,"empathy",921,160,360,520,1
"5419","15",43,"reciprocity",1396,320,220,540,1
"5420","15",44,"reciprocity",1875,240,300,540,1
"5421","15",45,"reciprocity",1545,280,280,560,1
"5422","15",46,"reciprocity",1364,180,340,520,1
"5423","15",47,"reciprocity",816,120,360,480,1
"5424","15",48,"reciprocity",921,20,380,400,1
"5425","15",49,"empathy",985,340,180,520,1
"5426","15",50,"empathy",747,120,360,480,1
"5427","15",51,"empathy",918,380,100,480,1
"5428","15",52,"reciprocity",1123,380,40,420,0
"5429","15",53,"reciprocity",1430,380,60,440,1
"5430","15",54,"reciprocity",1227,160,360,520,1
"5431","15",55,"empathy",1320,280,280,560,1
"5432","15",56,"empathy",1106,60,380,440,1
"5434","15",58,"empathy",1871,40,380,420,1
"5435","15",59,"empathy",1165,380,40,420,0
"5436","15",60,"empathy",1482,240,300,540,0
"5437","15",61,"empathy",1001,120,360,480,1
"5438","15",62,"empathy",1789,60,380,440,1
"5440","15",64,"empathy",1000,20,380,400,1
"5441","15",65,"empathy",2279,300,240,540,1
"5442","15",66,"empathy",851,380,60,440,0
"5444","15",68,"reciprocity",1168,320,220,540,1
"5445","15",69,"reciprocity",704,60,380,440,1
"5446","15",70,"reciprocity",1468,360,120,480,1
"5447","15",71,"reciprocity",910,380,100,480,1
"5448","15",72,"reciprocity",1278,300,240,540,1
"5449","15",73,"reciprocity",1265,300,240,540,1
"5450","15",74,"reciprocity",753,100,380,480,1
"5452","15",76,"reciprocity",1730,220,320,540,1
"5453","15",77,"reciprocity",793,100,380,480,1
"5454","15",78,"reciprocity",1887,240,300,540,1
"5455","15",79,"reciprocity",1805,340,180,520,1
"5456","15",80,"reciprocity",1253,380,60,440,1
"5457","15",81,"reciprocity",1511,380,20,400,1
"5458","15",82,"empathy",778,100,380,480,1
"5460","15",84,"empathy",2562,360,160,520,1
"5461","16",1,"multi-motive",1637,100,380,480,1
"5462","16",2,"multi-motive",2777,360,120,480,1
"5463","16",3,"multi-motive",2332,320,220,540,1
"5464","16",4,"multi-motive",2584,380,40,420,1
"5465","16",5,"multi-motive",1347,100,380,480,1
"5466","16",6,"multi-motive",2584,380,60,440,0
"5467","16",7,"control",1715,360,120,480,1
"5468","16",8,"control",1355,220,320,540,1
"5469","16",9,"control",3052,160,360,520,0
"5471","16",11,"control",2880,60,380,440,1
"5472","16",12,"control",2204,320,220,540,1
"5473","16",13,"multi-motive",1414,180,340,520,1
"5474","16",14,"multi-motive",1604,120,360,480,1
"5475","16",15,"multi-motive",2371,120,360,480,1
"5477","16",17,"control",2914,360,120,480,0
"5478","16",18,"control",1315,300,240,540,1
"5479","16",19,"multi-motive",1416,300,240,540,1
"5481","16",21,"multi-motive",1986,220,320,540,1
"5482","16",22,"multi-motive",1887,240,300,540,1
"5483","16",23,"multi-motive",2399,340,180,520,1
"5484","16",24,"multi-motive",2118,340,180,520,1
"5485","16",25,"control",2957,180,340,520,1
"5486","16",26,"control",2695,340,180,520,0
"5487","16",27,"control",1724,380,60,440,1
"5488","16",28,"control",1765,380,100,480,1
"5489","16",29,"control",2592,380,20,400,0
"5490","16",30,"control",3045,300,240,540,1
"5491","16",31,"multi-motive",1626,40,380,420,1
"5492","16",32,"multi-motive",1440,360,160,520,1
"5493","16",33,"multi-motive",1446,280,280,560,1
"5494","16",34,"control",1699,240,300,540,1
"5495","16",35,"control",1623,100,380,480,1
"5496","16",36,"control",2905,380,60,440,0
"5497","16",37,"control",2350,220,320,540,1
"5498","16",38,"control",2525,360,160,520,1
"5499","16",39,"control",3136,380,40,420,0
"5500","16",40,"multi-motive",1506,380,100,480,1
"5502","16",42,"multi-motive",1385,60,380,440,1
"5503","16",43,"multi-motive",1639,20,380,400,1
"5504","16",44,"multi-motive",1907,160,360,520,1
"5506","16",46,"control",1607,360,160,520,1
"5507","16",47,"control",1149,160,360,520,1
"5508","16",48,"control",1894,100,380,480,0
"5509","16",49,"control",2189,380,20,400,0
"5510","16",50,"control",1388,40,380,420,1
"5511","16",51,"control",1854,240,300,540,1
"5512","16",52,"multi-motive",1047,40,380,420,1
"5513","16",53,"multi-motive",1993,380,40,420,1
"5514","16",54,"multi-motive",1398,380,20,400,1
"5515","16",55,"multi-motive",1603,160,360,520,1
"5516","16",56,"multi-motive",2276,360,120,480,1
"5517","16",57,"multi-motive",1669,380,20,400,1
"5518","16",58,"multi-motive",1383,180,340,520,1
"5519","16",59,"multi-motive",2537,380,60,440,1
"5520","16",60,"multi-motive",1850,380,100,480,1
"5521","16",61,"control",1132,60,380,440,1
"5523","16",63,"control",1456,180,340,520,1
"5524","16",64,"control",1883,20,380,400,1
"5525","16",65,"control",1548,380,40,420,1
"5526","16",66,"control",2937,280,280,560,0
"5527","16",67,"multi-motive",1306,320,220,540,1
"5528","16",68,"multi-motive",1114,20,380,400,1
"5529","16",69,"multi-motive",1526,240,300,540,1
"5530","16",70,"control",1849,20,380,400,1
"5531","16",71,"control",1336,120,360,480,1
"5532","16",72,"control",2826,120,360,480,1
"5533","16",73,"control",1475,280,280,560,1
"5534","16",74,"control",3076,40,380,420,1
"5536","16",76,"control",1406,340,180,520,1
"5537","16",77,"control",2271,380,100,480,0
"5538","16",78,"control",1111,320,220,540,1
"5539","16",79,"multi-motive",1592,360,160,520,1
"5540","16",80,"multi-motive",1390,280,280,560,1
"5541","16",81,"multi-motive",1450,220,320,540,1
"5542","16",82,"multi-motive",1560,300,240,540,1
"5545","17",1,"multi-motive",1088,340,180,520,1
"5546","17",2,"multi-motive",563,40,380,420,1
"5547","17",3,"multi-motive",623,240,300,540,1
"5548","17",4,"multi-motive",934,300,240,540,1
"5549","17",5,"multi-motive",601,100,380,480,1
"5550","17",6,"multi-motive",802,160,360,520,1
"5551","17",7,"control",1191,380,40,420,0
"5552","17",8,"control",1347,160,360,520,1
"5553","17",9,"control",712,60,380,440,1
"5554","17",10,"multi-motive",929,380,100,480,0
"5556","17",12,"multi-motive",653,120,360,480,1
"5557","17",13,"multi-motive",737,380,60,440,0
"5558","17",14,"multi-motive",578,60,380,440,1
"5559","17",15,"multi-motive",946,280,280,560,1
"5560","17",16,"multi-motive",825,320,220,540,1
"5561","17",17,"multi-motive",1104,380,20,400,0
"5562","17",18,"multi-motive",1056,380,100,480,0
"5563","17",19,"multi-motive",1022,220,320,540,1
"5564","17",20,"multi-motive",650,220,320,540,1
"5565","17",21,"multi-motive",821,380,20,400,0
"5566","17",22,"control",624,20,380,400,1
"5567","17",23,"control",869,120,360,480,1
"5568","17",24,"control",895,380,100,480,0
"5569","17",25,"control",1806,100,380,480,1
"5571","17",27,"control",1036,380,20,400,0
"5572","17",28,"control",820,380,20,400,0
"5573","17",29,"control",723,100,380,480,1
"5575","17",31,"control",693,380,40,420,0
"5577","17",33,"control",1505,340,180,520,0
"5578","17",34,"control",1685,240,300,540,0
"5579","17",35,"control",1235,40,380,420,1
"5580","17",36,"control",1247,20,380,400,1
"5581","17",37,"multi-motive",901,120,360,480,1
"5582","17",38,"multi-motive",1304,380,40,420,0
"5583","17",39,"multi-motive",1075,380,40,420,0
"5585","17",41,"control",1511,120,360,480,0
"5586","17",42,"control",738,360,120,480,0
"5587","17",43,"multi-motive",865,20,380,400,1
"5588","17",44,"multi-motive",1920,240,300,540,0
"5589","17",45,"multi-motive",903,180,340,520,1
"5590","17",46,"control",743,220,320,540,0
"5591","17",47,"control",847,300,240,540,0
"5592","17",48,"control",1222,300,240,540,0
"5593","17",49,"control",1266,280,280,560,0
"5594","17",50,"control",749,40,380,420,1
"5595","17",51,"control",1091,220,320,540,1
"5596","17",52,"control",849,360,160,520,0
"5597","17",53,"control",776,320,220,540,0
"5598","17",54,"control",914,240,300,540,0
"5599","17",55,"multi-motive",1083,360,120,480,1
"5601","17",57,"multi-motive",1029,360,120,480,1
"5602","17",58,"multi-motive",1065,40,380,420,1
"5603","17",59,"multi-motive",693,100,380,480,1
"5604","17",60,"multi-motive",727,300,240,540,1
"5605","17",61,"multi-motive",631,20,380,400,1
"5606","17",62,"multi-motive",598,340,180,520,1
"5607","17",63,"multi-motive",888,320,220,540,0
"5608","17",64,"control",1376,360,120,480,0
"5609","17",65,"control",789,380,100,480,0
"5610","17",66,"control",873,360,160,520,0
"5611","17",67,"control",1280,280,280,560,1
"5612","17",68,"control",1122,60,380,440,1
"5613","17",69,"control",1122,180,340,520,0
"5614","17",70,"multi-motive",897,380,60,440,0
"5615","17",71,"multi-motive",1334,360,160,520,0
"5616","17",72,"multi-motive",1049,360,160,520,1
"5617","17",73,"control",1170,180,340,520,1
"5618","17",74,"control",907,160,360,520,1
"5619","17",75,"control",959,380,60,440,0
"5620","17",76,"multi-motive",586,60,380,440,1
"5621","17",77,"multi-motive",569,180,340,520,1
"5622","17",78,"multi-motive",1376,280,280,560,0
"5625","17",81,"multi-motive",730,160,360,520,1
"5627","17",83,"control",1562,340,180,520,0
"5628","17",84,"control",1487,320,220,540,0
"5629","18",1,"multi-motive",2068,360,160,520,1
"5630","18",2,"multi-motive",838,40,380,420,1
"5631","18",3,"multi-motive",2134,380,100,480,0
"5632","18",4,"control",1182,20,380,400,1
"5633","18",5,"control",1260,160,360,520,1
"5634","18",6,"control",1891,120,360,480,1
"5635","18",7,"multi-motive",1058,40,380,420,1
"5636","18",8,"multi-motive",1808,380,40,420,1
"5637","18",9,"multi-motive",759,60,380,440,1
"5638","18",10,"multi-motive",1100,180,340,520,1
"5639","18",11,"multi-motive",1719,380,20,400,1
"5642","18",14,"control",1878,380,100,480,0
"5643","18",15,"control",1150,240,300,540,1
"5645","18",17,"multi-motive",2210,340,180,520,1
"5648","18",20,"multi-motive",1273,380,60,440,1
"5649","18",21,"multi-motive",1025,240,300,540,1
"5650","18",22,"control",994,380,20,400,1
"5651","18",23,"control",3597,340,180,520,1
"5652","18",24,"control",1184,160,360,520,1
"5653","18",25,"control",1900,120,360,480,1
"5654","18",26,"control",887,60,380,440,1
"5655","18",27,"control",3774,180,340,520,1
"5656","18",28,"control",2634,100,380,480,1
"5657","18",29,"control",1811,360,160,520,1
"5658","18",30,"control",2054,360,120,480,1
"5659","18",31,"multi-motive",1385,380,60,440,1
"5660","18",32,"multi-motive",3639,340,180,520,0
"5661","18",33,"multi-motive",1044,160,360,520,1
"5662","18",34,"multi-motive",2725,280,280,560,0
"5663","18",35,"multi-motive",1062,160,360,520,1
"5664","18",36,"multi-motive",3116,300,240,540,1
"5665","18",37,"multi-motive",709,220,320,540,1
"5666","18",38,"multi-motive",977,220,320,540,1
"5667","18",39,"multi-motive",3073,180,340,520,1
"5668","18",40,"control",2571,360,120,480,0
"5670","18",42,"control",2109,220,320,540,1
"5672","18",44,"control",1615,280,280,560,1
"5673","18",45,"control",1701,380,40,420,1
"5675","18",47,"multi-motive",941,320,220,540,1
"5676","18",48,"multi-motive",2185,100,380,480,0
"5678","18",50,"control",1177,240,300,540,1
"5679","18",51,"control",1715,340,180,520,1
"5681","18",53,"control",1208,320,220,540,1
"5682","18",54,"control",779,280,280,560,1
"5684","18",56,"multi-motive",696,120,360,480,1
"5685","18",57,"multi-motive",850,380,40,420,0
"5686","18",58,"multi-motive",907,300,240,540,1
"5687","18",59,"multi-motive",2513,20,380,400,0
"5688","18",60,"multi-motive",929,120,360,480,1
"5689","18",61,"multi-motive",881,280,280,560,1
"5690","18",62,"multi-motive",881,380,20,400,1
"5691","18",63,"multi-motive",2995,360,120,480,1
"5692","18",64,"control",908,100,380,480,1
"5693","18",65,"control",618,300,240,540,1
"5694","18",66,"control",3308,380,60,440,0
"5695","18",67,"control",2984,380,60,440,1
"5696","18",68,"control",3234,380,100,480,1
"5697","18",69,"control",2627,380,40,420,1
"5698","18",70,"control",3311,60,380,440,1
"5699","18",71,"control",898,40,380,420,1
"5700","18",72,"control",2536,300,240,540,1
"5702","18",74,"control",754,220,320,540,1
"5703","18",75,"control",3790,380,20,400,1
"5704","18",76,"multi-motive",985,380,100,480,1
"5705","18",77,"multi-motive",744,20,380,400,1
"5708","18",80,"multi-motive",1293,360,160,520,1
"5709","18",81,"multi-motive",1766,320,220,540,0
"5710","18",82,"control",1790,40,380,420,1
"5712","18",84,"control",691,360,160,520,1
"5713","19",1,"reciprocity",2373,220,320,540,1
"5714","19",2,"reciprocity",3980,300,240,540,0
"5717","19",5,"empathy",963,60,380,440,1
"5719","19",7,"empathy",2815,40,380,420,1
"5720","19",8,"empathy",1098,280,280,560,1
"5721","19",9,"empathy",1655,240,300,540,0
"5722","19",10,"empathy",1007,100,380,480,1
"5723","19",11,"empathy",832,160,360,520,1
"5724","19",12,"empathy",739,100,380,480,1
"5725","19",13,"empathy",1560,380,20,400,0
"5726","19",14,"empathy",748,160,360,520,1
"5727","19",15,"empathy",900,380,40,420,1
"5728","19",16,"empathy",1566,380,60,440,0
"5729","19",17,"empathy",1648,360,120,480,0
"5730","19",18,"empathy",987,380,100,480,0
"5731","19",19,"reciprocity",1642,160,360,520,1
"5732","19",20,"reciprocity",1747,120,360,480,1
"5733","19",21,"reciprocity",1219,240,300,540,0
"5734","19",22,"reciprocity",761,20,380,400,1
"5735","19",23,"reciprocity",2229,120,360,480,0
"5736","19",24,"reciprocity",1920,60,380,440,1
"5737","19",25,"reciprocity",816,160,360,520,1
"5739","19",27,"reciprocity",1021,40,380,420,1
"5740","19",28,"reciprocity",2281,380,40,420,0
"5741","19",29,"reciprocity",1588,360,160,520,0
"5742","19",30,"reciprocity",1809,360,160,520,1
"5743","19",31,"reciprocity",2049,280,280,560,0
"5744","19",32,"reciprocity",899,100,380,480,1
"5745","19",33,"reciprocity",2773,100,380,480,0
"5746","19",34,"empathy",982,180,340,520,1
"5747","19",35,"empathy",1564,340,180,520,1
"5748","19",36,"empathy",2129,60,380,440,1
"5749","19",37,"reciprocity",2808,320,220,540,1
"5750","19",38,"reciprocity",2666,280,280,560,1
"5751","19",39,"reciprocity",1778,380,100,480,0
"5753","19",41,"empathy",2412,340,180,520,0
"5754","19",42,"empathy",2247,360,120,480,0
"5755","19",43,"empathy",1328,300,240,540,1
"5757","19",45,"empathy",3970,380,40,420,0
"5758","19",46,"empathy",2412,220,320,540,1
"5759","19",47,"empathy",3489,120,360,480,1
"5760","19",48,"empathy",1220,40,380,420,1
"5761","19",49,"reciprocity",1022,360,120,480,1
"5762","19",50,"reciprocity",1417,380,60,440,0
"5763","19",51,"reciprocity",2164,380,40,420,0
"5764","19",52,"reciprocity",3364,380,60,440,0
"5765","19",53,"reciprocity",1019,320,220,540,0
"5766","19",54,"reciprocity",2888,40,380,420,1
"5767","19",55,"empathy",1300,20,380,400,1
"5768","19",56,"empathy",1924,360,160,520,0
"5769","19",57,"empathy",2425,380,20,400,1
"5770","19",58,"empathy",2475,320,220,540,1
"5771","19",59,"empathy",1403,380,60,440,1
"5772","19",60,"empathy",1390,360,160,520,1
"5773","19",61,"reciprocity",2060,220,320,540,1
"5775","19",63,"reciprocity",2066,380,20,400,0
"5776","19",64,"reciprocity",1881,240,300,540,1
"5777","19",65,"reciprocity",1403,180,340,520,1
"5778","19",66,"reciprocity",3246,180,340,520,1
"5779","19",67,"reciprocity",3492,20,380,400,1
"5781","19",69,"reciprocity",1949,340,180,520,0
"5782","19",70,"empathy",770,240,300,540,1
"5783","19",71,"empathy",1283,300,240,540,0
"5785","19",73,"empathy",1638,380,100,480,0
"5786","19",74,"empathy",1638,280,280,560,0
"5787","19",75,"empathy",1662,320,220,540,1
"5788","19",76,"reciprocity",959,300,240,540,1
"5789","19",77,"reciprocity",1529,340,180,520,1
"5790","19",78,"reciprocity",1343,380,20,400,0
"5791","19",79,"reciprocity",1392,360,120,480,0
"5792","19",80,"reciprocity",1969,380,100,480,0
"5793","19",81,"reciprocity",2460,60,380,440,1
"5794","19",82,"empathy",1850,180,340,520,0
"5795","19",83,"empathy",1645,120,360,480,1
"5796","19",84,"empathy",2058,220,320,540,1
"5797","20",1,"empathy",2692,380,60,440,1
"5799","20",3,"empathy",1589,280,280,560,0
"5800","20",4,"reciprocity",1454,280,280,560,1
"5801","20",5,"reciprocity",1463,180,340,520,1
"5802","20",6,"reciprocity",2851,380,20,400,0
"5804","20",8,"empathy",1856,180,340,520,0
"5805","20",9,"empathy",1596,220,320,540,1
"5806","20",10,"empathy",1463,60,380,440,1
"5807","20",11,"empathy",1538,280,280,560,1
"5808","20",12,"empathy",1694,380,20,400,1
"5809","20",13,"reciprocity",1692,380,60,440,1
"5810","20",14,"reciprocity",2635,340,180,520,1
"5811","20",15,"reciprocity",2911,100,380,480,0
"5812","20",16,"empathy",2643,20,380,400,1
"5813","20",17,"empathy",1514,100,380,480,0
"5814","20",18,"empathy",2477,380,100,480,1
"5816","20",20,"empathy",2631,240,300,540,0
"5817","20",21,"empathy",3504,120,360,480,0
"5818","20",22,"empathy",1291,40,380,420,1
"5819","20",23,"empathy",2679,300,240,540,1
"5820","20",24,"empathy",2111,380,100,480,0
"5821","20",25,"reciprocity",1643,360,160,520,0
"5822","20",26,"reciprocity",1333,180,340,520,0
"5823","20",27,"reciprocity",2790,120,360,480,1
"5824","20",28,"reciprocity",1715,320,220,540,1
"5825","20",29,"reciprocity",1538,160,360,520,0
"5826","20",30,"reciprocity",3587,60,380,440,0
"5827","20",31,"reciprocity",2400,240,300,540,1
"5829","20",33,"reciprocity",3198,380,20,400,0
"5830","20",34,"empathy",2881,380,40,420,0
"5831","20",35,"empathy",1310,180,340,520,1
"5832","20",36,"empathy",2947,360,160,520,0
"5833","20",37,"reciprocity",1984,380,100,480,1
"5834","20",38,"reciprocity",3130,220,320,540,0
"5835","20",39,"reciprocity",3573,340,180,520,1
"5836","20",40,"empathy",1413,320,220,540,1
"5837","20",41,"empathy",2234,340,180,520,0
"5838","20",42,"empathy",1673,20,380,400,1
"5839","20",43,"empathy",3166,160,360,520,0
"5840","20",44,"empathy",1297,240,300,540,1
"5841","20",45,"empathy",3824,380,40,420,0
"5842","20",46,"reciprocity",1672,360,120,480,0
"5843","20",47,"reciprocity",1382,60,380,440,1
"5844","20",48,"reciprocity",1104,40,380,420,1
"5845","20",49,"empathy",2503,380,60,440,0
"5846","20",50,"empathy",1034,100,380,480,1
"5847","20",51,"empathy",3147,360,160,520,0
"5848","20",52,"reciprocity",1890,380,40,420,0
"5849","20",53,"reciprocity",2268,40,380,420,0
"5850","20",54,"reciprocity",1182,300,240,540,1
"5851","20",55,"empathy",2979,340,180,520,1
"5852","20",56,"empathy",1423,360,120,480,1
"5853","20",57,"empathy",2564,60,380,440,0
"5855","20",59,"reciprocity",1622,240,300,540,0
"5857","20",61,"empathy",3268,380,20,400,0
"5859","20",63,"empathy",2219,320,220,540,0
"5860","20",64,"empathy",2635,360,120,480,0
"5861","20",65,"empathy",1190,300,240,540,0
"5862","20",66,"empathy",1557,220,320,540,0
"5863","20",67,"empathy",2037,160,360,520,1
"5864","20",68,"empathy",3489,40,380,420,1
"5865","20",69,"empathy",2344,120,360,480,0
"5866","20",70,"reciprocity",2982,360,160,520,1
"5868","20",72,"reciprocity",3026,380,40,420,0
"5869","20",73,"reciprocity",1626,20,380,400,1
"5870","20",74,"reciprocity",2627,380,60,440,0
"5871","20",75,"reciprocity",2155,300,240,540,0
"5872","20",76,"reciprocity",1363,320,220,540,0
"5873","20",77,"reciprocity",1473,280,280,560,0
"5874","20",78,"reciprocity",2389,120,360,480,0
"5876","20",80,"reciprocity",2247,360,120,480,1
"5877","20",81,"reciprocity",2391,220,320,540,1
"5878","20",82,"reciprocity",1260,160,360,520,1
"5879","20",83,"reciprocity",1077,380,100,480,0
"5880","20",84,"reciprocity",1708,100,380,480,1
"5965","21",1,"empathy",1328,120,360,480,1
"5966","21",2,"empathy",1213,100,380,480,1
"5967","21",3,"empathy",1387,380,40,420,0
"5968","21",4,"empathy",1924,380,100,480,1
"5969","21",5,"empathy",1746,380,60,440,1
"5970","21",6,"empathy",1264,340,180,520,1
"5971","21",7,"reciprocity",1389,240,300,540,1
"5972","21",8,"reciprocity",1298,280,280,560,1
"5973","21",9,"reciprocity",2338,320,220,540,1
"5975","21",11,"empathy",1378,380,60,440,1
"5976","21",12,"empathy",2093,180,340,520,1
"5977","21",13,"reciprocity",1466,60,380,440,1
"5978","21",14,"reciprocity",1810,380,60,440,0
"5979","21",15,"reciprocity",1803,40,380,420,1
"5980","21",16,"empathy",1447,60,380,440,1
"5981","21",17,"empathy",1787,280,280,560,1
"5982","21",18,"empathy",1644,320,220,540,1
"5983","21",19,"empathy",1502,160,360,520,1
"5984","21",20,"empathy",1687,20,380,400,1
"5985","21",21,"empathy",1470,40,380,420,1
"5986","21",22,"reciprocity",1803,120,360,480,1
"5988","21",24,"reciprocity",1292,40,380,420,1
"5989","21",25,"reciprocity",2557,360,120,480,0
"5990","21",26,"reciprocity",1372,20,380,400,1
"5991","21",27,"reciprocity",1398,300,240,540,1
"5992","21",28,"reciprocity",2708,340,180,520,1
"5993","21",29,"reciprocity",1764,240,300,540,1
"5994","21",30,"reciprocity",2722,360,160,520,0
"5995","21",31,"empathy",1317,120,360,480,1
"5996","21",32,"empathy",1359,220,320,540,1
"5997","21",33,"empathy",1329,40,380,420,1
"5998","21",34,"reciprocity",1558,380,40,420,0
"5999","21",35,"reciprocity",930,100,380,480,1
"6000","21",36,"reciprocity",2195,300,240,540,1
"6001","21",37,"empathy",1533,340,180,520,1
"6002","21",38,"empathy",1482,100,380,480,1
"6003","21",39,"empathy",2020,380,20,400,0
"6004","21",40,"reciprocity",1433,120,360,480,1
"6005","21",41,"reciprocity",1579,180,340,520,1
"6006","21",42,"reciprocity",2963,320,220,540,1
"6007","21",43,"reciprocity",1473,380,40,420,0
"6010","21",46,"empathy",2046,320,220,540,1
"6011","21",47,"empathy",1660,280,280,560,1
"6012","21",48,"empathy",1404,300,240,540,1
"6013","21",49,"reciprocity",1343,160,360,520,1
"6014","21",50,"reciprocity",2391,360,120,480,0
"6015","21",51,"reciprocity",1217,180,340,520,1
"6016","21",52,"empathy",1262,240,300,540,1
"6017","21",53,"empathy",1378,360,160,520,1
"6020","21",56,"reciprocity",1342,220,320,540,1
"6021","21",57,"reciprocity",1225,60,380,440,1
"6022","21",58,"empathy",1464,220,320,540,1
"6023","21",59,"empathy",2870,360,120,480,1
"6024","21",60,"empathy",1394,60,380,440,1
"6025","21",61,"reciprocity",2406,380,100,480,0
"6026","21",62,"reciprocity",1072,20,380,400,1
"6027","21",63,"reciprocity",1900,340,180,520,1
"6028","21",64,"reciprocity",1665,380,20,400,1
"6029","21",65,"reciprocity",1415,160,360,520,1
"6030","21",66,"reciprocity",1405,280,280,560,1
"6031","21",67,"empathy",1473,180,340,520,1
"6033","21",69,"empathy",1851,360,160,520,1
"6034","21",70,"reciprocity",1869,220,320,540,1
"6035","21",71,"reciprocity",1665,380,100,480,1
"6036","21",72,"reciprocity",2210,380,20,400,1
"6037","21",73,"empathy",1752,240,300,540,1
"6038","21",74,"empathy",2426,360,120,480,0
"6039","21",75,"empathy",2256,380,20,400,0
"6040","21",76,"empathy",2071,380,40,420,1
"6041","21",77,"empathy",2183,160,360,520,1
"6042","21",78,"empathy",1499,20,380,400,1
"6044","21",80,"empathy",1592,300,240,540,1
"6045","21",81,"empathy",1991,380,100,480,0
"6046","21",82,"reciprocity",2712,380,60,440,1
"6047","21",83,"reciprocity",1717,100,380,480,1
"6048","21",84,"reciprocity",3311,360,160,520,1
"6049","22",1,"multi-motive",2465,120,360,480,1
"6050","22",2,"multi-motive",2583,60,380,440,1
"6051","22",3,"multi-motive",2162,220,320,540,1
"6052","22",4,"control",1477,380,20,400,1
"6053","22",5,"control",2325,180,340,520,0
"6054","22",6,"control",2739,380,100,480,0
"6055","22",7,"multi-motive",2334,320,220,540,1
"6056","22",8,"multi-motive",1946,380,60,440,1
"6057","22",9,"multi-motive",3099,380,20,400,0
"6059","22",11,"control",1867,20,380,400,1
"6060","22",12,"control",1629,40,380,420,1
"6061","22",13,"control",2375,380,100,480,0
"6062","22",14,"control",1634,300,240,540,0
"6063","22",15,"control",1297,100,380,480,1
"6064","22",16,"multi-motive",1647,360,160,520,1
"6065","22",17,"multi-motive",2614,240,300,540,1
"6066","22",18,"multi-motive",2473,340,180,520,0
"6069","22",21,"multi-motive",1430,360,120,480,1
"6070","22",22,"control",1776,360,120,480,1
"6072","22",24,"control",2934,240,300,540,0
"6073","22",25,"control",1578,340,180,520,0
"6074","22",26,"control",1715,240,300,540,0
"6075","22",27,"control",3150,220,320,540,0
"6076","22",28,"multi-motive",1876,300,240,540,1
"6077","22",29,"multi-motive",2509,60,380,440,1
"6079","22",31,"control",2284,380,40,420,0
"6080","22",32,"control",1938,320,220,540,0
"6081","22",33,"control",2197,60,380,440,1
"6082","22",34,"control",2845,60,380,440,0
"6084","22",36,"control",1104,180,340,520,1
"6085","22",37,"multi-motive",2899,180,340,520,1
"6086","22",38,"multi-motive",2907,180,340,520,0
"6088","22",40,"control",2700,120,360,480,0
"6089","22",41,"control",2105,20,380,400,1
"6090","22",42,"control",2273,380,60,440,0
"6092","22",44,"multi-motive",2968,340,180,520,1
"6093","22",45,"multi-motive",2167,320,220,540,0
"6094","22",46,"multi-motive",2697,20,380,400,1
"6095","22",47,"multi-motive",2690,380,60,440,1
"6096","22",48,"multi-motive",3446,220,320,540,0
"6097","22",49,"control",1784,280,280,560,0
"6098","22",50,"control",3071,320,220,540,0
"6099","22",51,"control",3112,340,180,520,1
"6100","22",52,"control",2909,120,360,480,1
"6101","22",53,"control",3391,300,240,540,1
"6102","22",54,"control",2955,360,160,520,0
"6103","22",55,"multi-motive",2086,380,40,420,1
"6104","22",56,"multi-motive",2193,20,380,400,1
"6105","22",57,"multi-motive",1896,160,360,520,1
"6106","22",58,"multi-motive",2803,360,160,520,1
"6107","22",59,"multi-motive",2142,280,280,560,1
"6108","22",60,"multi-motive",978,40,380,420,1
"6109","22",61,"multi-motive",1714,280,280,560,0
"6110","22",62,"multi-motive",1099,100,380,480,1
"6111","22",63,"multi-motive",1772,380,20,400,1
"6112","22",64,"multi-motive",1521,360,120,480,1
"6113","22",65,"multi-motive",1668,380,100,480,1
"6114","22",66,"multi-motive",2121,380,40,420,1
"6115","22",67,"control",1902,360,160,520,1
"6116","22",68,"control",2140,160,360,520,0
"6117","22",69,"control",2380,40,380,420,0
"6118","22",70,"multi-motive",1689,240,300,540,1
"6119","22",71,"multi-motive",1360,160,360,520,1
"6120","22",72,"multi-motive",1969,40,380,420,1
"6121","22",73,"control",2667,160,360,520,1
"6122","22",74,"control",1985,100,380,480,0
"6123","22",75,"control",2327,380,60,440,1
"6124","22",76,"control",1952,380,20,400,0
"6125","22",77,"control",2067,280,280,560,1
"6126","22",78,"control",1539,380,40,420,0
"6128","22",80,"control",1953,360,120,480,0
"6129","22",81,"control",1671,220,320,540,0
"6130","22",82,"multi-motive",2715,100,380,480,1
"6131","22",83,"multi-motive",1683,120,360,480,1
"6132","22",84,"multi-motive",2639,380,100,480,1
"6133","23",1,"multi-motive",1028,300,240,540,1
"6134","23",2,"multi-motive",1036,380,20,400,1
"6135","23",3,"multi-motive",909,100,380,480,1
"6136","23",4,"multi-motive",1562,20,380,400,1
"6137","23",5,"multi-motive",1211,380,100,480,1
"6138","23",6,"multi-motive",1462,60,380,440,1
"6139","23",7,"control",1131,380,60,440,1
"6140","23",8,"control",1203,280,280,560,1
"6141","23",9,"control",1180,60,380,440,1
"6143","23",11,"control",1022,380,100,480,1
"6144","23",12,"control",1413,340,180,520,1
"6146","23",14,"control",781,360,160,520,1
"6148","23",16,"multi-motive",746,120,360,480,1
"6149","23",17,"multi-motive",1223,40,380,420,1
"6151","23",19,"multi-motive",1077,340,180,520,1
"6152","23",20,"multi-motive",1287,360,120,480,0
"6154","23",22,"multi-motive",972,380,60,440,1
"6155","23",23,"multi-motive",1485,340,180,520,1
"6156","23",24,"multi-motive",749,40,380,420,1
"6157","23",25,"control",783,180,340,520,1
"6158","23",26,"control",1188,380,40,420,1
"6159","23",27,"control",1220,280,280,560,1
"6160","23",28,"control",1567,380,60,440,1
"6161","23",29,"control",1464,100,380,480,1
"6162","23",30,"control",755,60,380,440,1
"6163","23",31,"multi-motive",1227,20,380,400,1
"6165","23",33,"multi-motive",1512,240,300,540,0
"6166","23",34,"multi-motive",1115,240,300,540,1
"6167","23",35,"multi-motive",847,360,120,480,1
"6168","23",36,"multi-motive",903,180,340,520,1
"6169","23",37,"control",1533,40,380,420,1
"6170","23",38,"control",994,360,120,480,1
"6171","23",39,"control",956,220,320,540,1
"6172","23",40,"multi-motive",1372,180,340,520,1
"6173","23",41,"multi-motive",858,280,280,560,1
"6174","23",42,"multi-motive",932,300,240,540,1
"6175","23",43,"multi-motive",1114,360,160,520,0
"6176","23",44,"multi-motive",948,380,60,440,1
"6177","23",45,"multi-motive",1152,320,220,540,1
"6178","23",46,"multi-motive",1329,380,40,420,1
"6179","23",47,"multi-motive",1800,320,220,540,1
"6180","23",48,"multi-motive",1872,160,360,520,0
"6181","23",49,"control",934,300,240,540,1
"6182","23",50,"control",1828,360,160,520,1
"6183","23",51,"control",2521,380,20,400,0
"6184","23",52,"control",1879,320,220,540,1
"6186","23",54,"control",825,240,300,540,1
"6187","23",55,"control",797,160,360,520,1
"6188","23",56,"control",2054,380,40,420,1
"6189","23",57,"control",2131,160,360,520,1
"6190","23",58,"control",1413,100,380,480,1
"6191","23",59,"control",1017,20,380,400,1
"6192","23",60,"control",1422,380,100,480,1
"6193","23",61,"control",1849,360,120,480,1
"6194","23",62,"control",1019,180,340,520,1
"6195","23",63,"control",1010,320,220,540,1
"6196","23",64,"multi-motive",990,100,380,480,1
"6197","23",65,"multi-motive",794,60,380,440,1
"6198","23",66,"multi-motive",1646,220,320,540,0
"6199","23",67,"multi-motive",1486,120,360,480,1
"6200","23",68,"multi-motive",1819,280,280,560,1
"6202","23",70,"control",1136,40,380,420,1
"6203","23",71,"control",1553,380,20,400,1
"6206","23",74,"multi-motive",868,360,160,520,1
"6207","23",75,"multi-motive",1948,380,20,400,0
"6208","23",76,"control",1601,300,240,540,1
"6209","23",77,"control",670,20,380,400,1
"6210","23",78,"control",729,120,360,480,1
"6211","23",79,"multi-motive",993,160,360,520,1
"6212","23",80,"multi-motive",1080,380,40,420,1
"6213","23",81,"multi-motive",1200,380,100,480,1
"6214","23",82,"control",960,120,360,480,1
"6215","23",83,"control",1237,240,300,540,1
"6216","23",84,"control",934,340,180,520,1
"6217","24",1,"multi-motive",2787,360,120,480,0
"6218","24",2,"multi-motive",2292,240,300,540,1
"6220","24",4,"multi-motive",1183,220,320,540,1
"6221","24",5,"multi-motive",3080,240,300,540,0
"6222","24",6,"multi-motive",1343,380,20,400,1
"6223","24",7,"control",2676,380,60,440,0
"6225","24",9,"control",1736,40,380,420,0
"6226","24",10,"control",2101,20,380,400,0
"6227","24",11,"control",1428,100,380,480,1
"6230","24",14,"multi-motive",939,100,380,480,1
"6231","24",15,"multi-motive",3086,180,340,520,1
"6232","24",16,"multi-motive",2391,380,20,400,0
"6234","24",18,"multi-motive",2123,160,360,520,1
"6235","24",19,"control",3648,360,160,520,1
"6236","24",20,"control",915,20,380,400,1
"6237","24",21,"control",760,60,380,440,1
"6238","24",22,"control",1730,220,320,540,0
"6239","24",23,"control",3210,380,100,480,1
"6240","24",24,"control",3135,120,360,480,1
"6241","24",25,"multi-motive",1631,320,220,540,0
"6242","24",26,"multi-motive",3477,20,380,400,1
"6243","24",27,"multi-motive",749,40,380,420,1
"6244","24",28,"control",2721,180,340,520,1
"6245","24",29,"control",2021,100,380,480,0
"6246","24",30,"control",2852,380,40,420,0
"6247","24",31,"multi-motive",972,20,380,400,1
"6248","24",32,"multi-motive",2542,100,380,480,1
"6249","24",33,"multi-motive",3054,360,120,480,1
"6250","24",34,"control",2191,300,240,540,1
"6251","24",35,"control",1915,280,280,560,0
"6252","24",36,"control",877,40,380,420,1
"6253","24",37,"control",2104,280,280,560,0
"6255","24",39,"control",2539,160,360,520,0
"6256","24",40,"multi-motive",1865,300,240,540,1
"6259","24",43,"control",2468,340,180,520,1
"6260","24",44,"control",3042,160,360,520,1
"6261","24",45,"control",1726,220,320,540,1
"6262","24",46,"control",1541,360,160,520,0
"6263","24",47,"control",1534,380,100,480,0
"6264","24",48,"control",1903,300,240,540,0
"6265","24",49,"control",2779,380,40,420,1
"6267","24",51,"control",1619,380,60,440,0
"6268","24",52,"multi-motive",2181,280,280,560,1
"6269","24",53,"multi-motive",1380,60,380,440,1
"6270","24",54,"multi-motive",2132,360,160,520,1
"6271","24",55,"control",3224,120,360,480,1
"6272","24",56,"control",1482,320,220,540,1
"6273","24",57,"control",1984,380,20,400,1
"6274","24",58,"multi-motive",1895,380,60,440,0
"6275","24",59,"multi-motive",2284,280,280,560,0
"6276","24",60,"multi-motive",2557,180,340,520,1
"6277","24",61,"control",1496,180,340,520,1
"6278","24",62,"control",2201,240,300,540,0
"6279","24",63,"control",2635,340,180,520,0
"6280","24",64,"multi-motive",1048,120,360,480,1
"6281","24",65,"multi-motive",1703,380,100,480,1
"6282","24",66,"multi-motive",2378,120,360,480,1
"6283","24",67,"multi-motive",3330,380,40,420,1
"6284","24",68,"multi-motive",3046,40,380,420,0
"6285","24",69,"multi-motive",1144,60,380,440,1
"6286","24",70,"control",2905,60,380,440,0
"6287","24",71,"control",2830,360,120,480,1
"6288","24",72,"control",1646,240,300,540,1
"6289","24",73,"control",1596,320,220,540,0
"6290","24",74,"control",2223,360,120,480,0
"6291","24",75,"control",2557,380,20,400,0
"6292","24",76,"multi-motive",1590,380,40,420,1
"6293","24",77,"multi-motive",1584,360,160,520,1
"6294","24",78,"multi-motive",1945,340,180,520,1
"6296","24",80,"multi-motive",1833,340,180,520,1
"6297","24",81,"multi-motive",1713,160,360,520,1
"6298","24",82,"multi-motive",1155,380,100,480,0
"6299","24",83,"multi-motive",2437,380,60,440,0
"6300","24",84,"multi-motive",1109,320,220,540,1
"6301","25",1,"multi-motive",3061,60,380,440,1
"6302","25",2,"multi-motive",3024,20,380,400,0
"6303","25",3,"multi-motive",1745,360,120,480,0
"6304","25",4,"control",2549,380,100,480,1
"6305","25",5,"control",1836,100,380,480,1
"6306","25",6,"control",2231,100,380,480,0
"6307","25",7,"multi-motive",1751,300,240,540,1
"6308","25",8,"multi-motive",1582,160,360,520,1
"6309","25",9,"multi-motive",3286,340,180,520,0
"6310","25",10,"control",2157,120,360,480,0
"6311","25",11,"control",1220,320,220,540,1
"6312","25",12,"control",1257,160,360,520,1
"6313","25",13,"multi-motive",1053,240,300,540,0
"6315","25",15,"multi-motive",1096,160,360,520,1
"6316","25",16,"control",2466,380,60,440,1
"6318","25",18,"control",1499,380,40,420,0
"6319","25",19,"multi-motive",3693,360,160,520,0
"6320","25",20,"multi-motive",2497,380,100,480,0
"6321","25",21,"multi-motive",2026,120,360,480,0
"6322","25",22,"control",1102,360,120,480,0
"6323","25",23,"control",2788,220,320,540,1
"6324","25",24,"control",1188,180,340,520,1
"6325","25",25,"multi-motive",3048,320,220,540,1
"6326","25",26,"multi-motive",3552,220,320,540,1
"6327","25",27,"multi-motive",2915,180,340,520,0
"6328","25",28,"control",2279,380,100,480,0
"6329","25",29,"control",2815,360,120,480,1
"6330","25",30,"control",1266,380,40,420,0
"6331","25",31,"control",1432,240,300,540,1
"6332","25",32,"control",2341,380,20,400,0
"6333","25",33,"control",1515,320,220,540,0
"6334","25",34,"multi-motive",2030,320,220,540,1
"6335","25",35,"multi-motive",1800,380,100,480,1
"6336","25",36,"multi-motive",780,60,380,440,0
"6338","25",38,"multi-motive",3082,380,40,420,0
"6339","25",39,"multi-motive",1278,20,380,400,1
"6341","25",41,"multi-motive",1014,280,280,560,1
"6342","25",42,"multi-motive",1107,180,340,520,1
"6343","25",43,"control",1089,120,360,480,1
"6344","25",44,"control",2443,20,380,400,0
"6345","25",45,"control",1691,60,380,440,1
"6346","25",46,"control",1620,280,280,560,1
"6347","25",47,"control",1418,240,300,540,0
"6348","25",48,"control",2616,180,340,520,1
"6349","25",49,"multi-motive",2697,100,380,480,1
"6350","25",50,"multi-motive",2617,240,300,540,1
"6351","25",51,"multi-motive",886,100,380,480,1
"6352","25",52,"control",1436,220,320,540,0
"6354","25",54,"control",2379,40,380,420,0
"6355","25",55,"control",2474,380,60,440,1
"6356","25",56,"control",1077,360,160,520,1
"6358","25",58,"control",2485,300,240,540,0
"6359","25",59,"control",1303,340,180,520,0
"6360","25",60,"control",1111,280,280,560,0
"6362","25",62,"multi-motive",1798,300,240,540,1
"6363","25",63,"multi-motive",1085,360,160,520,1
"6364","25",64,"control",1669,300,240,540,1
"6366","25",66,"control",827,40,380,420,1
"6367","25",67,"control",144,340,180,520,0
"6368","25",68,"control",1797,360,160,520,1
"6369","25",69,"control",1716,60,380,440,0
"6370","25",70,"control",1303,160,360,520,0
"6371","25",71,"control",1029,20,380,400,1
"6372","25",72,"control",3824,380,20,400,1
"6373","25",73,"multi-motive",2666,280,280,560,1
"6374","25",74,"multi-motive",2319,40,380,420,1
"6375","25",75,"multi-motive",1585,380,60,440,1
"6377","25",77,"multi-motive",1915,340,180,520,1
"6378","25",78,"multi-motive",1003,120,360,480,1
"6379","25",79,"multi-motive",1324,360,120,480,1
"6380","25",80,"multi-motive",3710,380,20,400,1
"6381","25",81,"multi-motive",1894,220,320,540,1
"6382","25",82,"multi-motive",3741,380,40,420,1
"6383","25",83,"multi-motive",1622,380,60,440,1
"6384","25",84,"multi-motive",785,40,380,420,1
"6385","26",1,"control",2466,360,120,480,1
"6386","26",2,"control",1556,300,240,540,1
"6387","26",3,"control",1404,240,300,540,1
"6388","26",4,"multi-motive",1025,340,180,520,0
"6389","26",5,"multi-motive",1998,280,280,560,0
"6390","26",6,"multi-motive",2922,120,360,480,0
"6391","26",7,"control",1807,120,360,480,0
"6392","26",8,"control",1155,380,100,480,1
"6393","26",9,"control",1080,160,360,520,1
"6394","26",10,"control",1019,340,180,520,1
"6395","26",11,"control",812,220,320,540,1
"6396","26",12,"control",1773,220,320,540,1
"6397","26",13,"control",1273,60,380,440,0
"6398","26",14,"control",1324,380,20,400,1
"6399","26",15,"control",1544,320,220,540,1
"6400","26",16,"control",2026,340,180,520,1
"6402","26",18,"control",1184,40,380,420,0
"6403","26",19,"multi-motive",1432,100,380,480,1
"6404","26",20,"multi-motive",1642,380,20,400,1
"6405","26",21,"multi-motive",3320,240,300,540,1
"6406","26",22,"multi-motive",1484,320,220,540,1
"6407","26",23,"multi-motive",3709,60,380,440,1
"6408","26",24,"multi-motive",1899,380,60,440,1
"6409","26",25,"multi-motive",1410,380,40,420,1
"6410","26",26,"multi-motive",1027,360,160,520,0
"6411","26",27,"multi-motive",1494,380,20,400,1
"6412","26",28,"control",2909,60,380,440,1
"6413","26",29,"control",1818,320,220,540,1
"6414","26",30,"control",1321,100,380,480,0
"6415","26",31,"multi-motive",1262,380,60,440,1
"6416","26",32,"multi-motive",835,240,300,540,1
"6417","26",33,"multi-motive",2170,380,100,480,1
"6418","26",34,"control",853,380,100,480,0
"6421","26",37,"multi-motive",1204,60,380,440,1
"6422","26",38,"multi-motive",2376,380,40,420,0
"6423","26",39,"multi-motive",1822,360,160,520,1
"6424","26",40,"multi-motive",1049,160,360,520,1
"6425","26",41,"multi-motive",1224,220,320,540,1
"6426","26",42,"multi-motive",1112,160,360,520,1
"6427","26",43,"control",1466,120,360,480,1
"6428","26",44,"control",1029,100,380,480,1
"6429","26",45,"control",1002,40,380,420,1
"6430","26",46,"control",1209,20,380,400,0
"6431","26",47,"control",2225,280,280,560,1
"6432","26",48,"control",1587,380,40,420,0
"6433","26",49,"multi-motive",1015,20,380,400,1
"6435","26",51,"multi-motive",815,120,360,480,1
"6436","26",52,"multi-motive",1654,360,120,480,1
"6438","26",54,"multi-motive",978,100,380,480,1
"6439","26",55,"control",1324,300,240,540,0
"6440","26",56,"control",1188,360,120,480,1
"6441","26",57,"control",909,380,60,440,1
"6443","26",59,"multi-motive",1929,180,340,520,1
"6444","26",60,"multi-motive",1206,280,280,560,1
"6445","26",61,"control",1285,240,300,540,0
"6446","26",62,"control",1171,160,360,520,0
"6447","26",63,"control",1102,360,160,520,1
"6448","26",64,"multi-motive",1605,180,340,520,1
"6449","26",65,"multi-motive",1464,40,380,420,1
"6450","26",66,"multi-motive",961,320,220,540,1
"6453","26",69,"control",1056,180,340,520,1
"6454","26",70,"multi-motive",1110,360,120,480,1
"6455","26",71,"multi-motive",2360,380,100,480,0
"6457","26",73,"control",1304,180,340,520,1
"6458","26",74,"control",2685,380,40,420,0
"6459","26",75,"control",1198,280,280,560,1
"6460","26",76,"control",3165,380,60,440,0
"6461","26",77,"control",1423,20,380,400,1
"6462","26",78,"control",1453,380,20,400,1
"6463","26",79,"multi-motive",884,220,320,540,1
"6464","26",80,"multi-motive",1018,40,380,420,1
"6465","26",81,"multi-motive",2939,20,380,400,1
"6466","26",82,"multi-motive",1887,300,240,540,0
"6467","26",83,"multi-motive",991,300,240,540,1
"6468","26",84,"multi-motive",731,340,180,520,1
"6469","27",1,"control",1398,60,380,440,0
"6471","27",3,"control",1255,360,160,520,0
"6473","27",5,"multi-motive",719,180,340,520,1
"6474","27",6,"multi-motive",1088,220,320,540,1
"6475","27",7,"multi-motive",879,340,180,520,1
"6476","27",8,"multi-motive",1789,360,120,480,1
"6477","27",9,"multi-motive",805,300,240,540,1
"6478","27",10,"multi-motive",669,40,380,420,1
"6479","27",11,"multi-motive",721,320,220,540,1
"6480","27",12,"multi-motive",1093,20,380,400,1
"6481","27",13,"control",739,380,20,400,0
"6482","27",14,"control",1083,240,300,540,0
"6483","27",15,"control",1191,220,320,540,0
"6484","27",16,"multi-motive",889,380,40,420,1
"6485","27",17,"multi-motive",895,60,380,440,1
"6486","27",18,"multi-motive",647,20,380,400,1
"6487","27",19,"control",1724,280,280,560,0
"6488","27",20,"control",717,120,360,480,1
"6489","27",21,"control",1602,40,380,420,0
"6490","27",22,"multi-motive",940,280,280,560,1
"6492","27",24,"multi-motive",751,40,380,420,1
"6493","27",25,"multi-motive",796,100,380,480,1
"6494","27",26,"multi-motive",779,120,360,480,1
"6495","27",27,"multi-motive",745,380,20,400,1
"6497","27",29,"control",1237,380,100,480,0
"6498","27",30,"control",2497,300,240,540,1
"6499","27",31,"control",1100,120,360,480,0
"6500","27",32,"control",959,280,280,560,0
"6501","27",33,"control",1263,380,60,440,0
"6503","27",35,"multi-motive",1453,380,20,400,1
"6504","27",36,"multi-motive",1609,380,100,480,1
"6505","27",37,"control",2110,180,340,520,1
"6506","27",38,"control",2567,100,380,480,1
"6507","27",39,"control",1007,360,120,480,0
"6508","27",40,"control",1051,380,40,420,0
"6509","27",41,"control",1374,340,180,520,0
"6510","27",42,"control",3289,240,300,540,1
"6511","27",43,"control",852,360,160,520,0
"6512","27",44,"control",984,300,240,540,0
"6513","27",45,"control",1099,380,40,420,0
"6514","27",46,"control",906,100,380,480,0
"6515","27",47,"control",1305,160,360,520,0
"6516","27",48,"control",1237,40,380,420,0
"6517","27",49,"multi-motive",912,360,120,480,1
"6518","27",50,"multi-motive",828,180,340,520,1
"6519","27",51,"multi-motive",811,220,320,540,1
"6520","27",52,"control",1247,360,120,480,0
"6521","27",53,"control",844,320,220,540,0
"6522","27",54,"control",849,320,220,540,0
"6523","27",55,"multi-motive",1227,380,40,420,1
"6524","27",56,"multi-motive",804,280,280,560,1
"6525","27",57,"multi-motive",1273,380,60,440,1
"6527","27",59,"multi-motive",783,300,240,540,1
"6528","27",60,"multi-motive",836,160,360,520,1
"6529","27",61,"control",1109,340,180,520,0
"6530","27",62,"control",876,380,100,480,0
"6531","27",63,"control",917,380,60,440,0
"6532","27",64,"multi-motive",1625,340,180,520,1
"6533","27",65,"multi-motive",1126,380,60,440,1
"6534","27",66,"multi-motive",981,120,360,480,1
"6535","27",67,"multi-motive",767,160,360,520,1
"6536","27",68,"multi-motive",1428,360,160,520,1
"6537","27",69,"multi-motive",755,360,160,520,1
"6538","27",70,"control",942,60,380,440,0
"6539","27",71,"control",997,20,380,400,0
"6540","27",72,"control",1192,160,360,520,0
"6541","27",73,"multi-motive",912,380,100,480,1
"6542","27",74,"multi-motive",877,240,300,540,1
"6543","27",75,"multi-motive",757,240,300,540,1
"6544","27",76,"control",1025,180,340,520,0
"6546","27",78,"control",1656,380,20,400,0
"6547","27",79,"control",1019,220,320,540,0
"6548","27",80,"control",2834,20,380,400,1
"6550","27",82,"multi-motive",733,320,220,540,1
"6551","27",83,"multi-motive",1140,100,380,480,1
"6552","27",84,"multi-motive",893,60,380,440,1
"6553","28",1,"control",1329,20,380,400,1
"6554","28",2,"control",2026,380,20,400,0
"6555","28",3,"control",3175,380,60,440,1
"6557","28",5,"multi-motive",1982,300,240,540,1
"6558","28",6,"multi-motive",1822,240,300,540,1
"6559","28",7,"control",2087,360,120,480,1
"6560","28",8,"control",1751,300,240,540,1
"6561","28",9,"control",1525,20,380,400,1
"6562","28",10,"multi-motive",863,20,380,400,1
"6563","28",11,"multi-motive",887,60,380,440,1
"6564","28",12,"multi-motive",931,320,220,540,1
"6565","28",13,"control",1508,180,340,520,1
"6566","28",14,"control",1480,280,280,560,1
"6567","28",15,"control",1000,180,340,520,1
"6568","28",16,"control",1281,60,380,440,1
"6569","28",17,"control",2534,380,40,420,0
"6570","28",18,"control",836,240,300,540,1
"6571","28",19,"control",1294,220,320,540,1
"6573","28",21,"control",900,60,380,440,1
"6574","28",22,"multi-motive",1486,300,240,540,1
"6575","28",23,"multi-motive",1388,380,40,420,1
"6576","28",24,"multi-motive",1136,160,360,520,1
"6577","28",25,"control",2254,320,220,540,1
"6579","28",27,"control",2074,340,180,520,1
"6580","28",28,"multi-motive",882,360,120,480,1
"6581","28",29,"multi-motive",1132,360,120,480,1
"6582","28",30,"multi-motive",1215,220,320,540,1
"6583","28",31,"multi-motive",1183,240,300,540,1
"6584","28",32,"multi-motive",1605,120,360,480,1
"6585","28",33,"multi-motive",2248,380,60,440,1
"6586","28",34,"control",1929,100,380,480,1
"6587","28",35,"control",3113,380,40,420,0
"6588","28",36,"control",1450,160,360,520,1
"6589","28",37,"control",1432,220,320,540,1
"6590","28",38,"control",1864,100,380,480,1
"6591","28",39,"control",1012,320,220,540,1
"6592","28",40,"multi-motive",1404,100,380,480,1
"6594","28",42,"multi-motive",1272,220,320,540,1
"6595","28",43,"multi-motive",1045,180,340,520,1
"6596","28",44,"multi-motive",983,280,280,560,1
"6597","28",45,"multi-motive",939,180,340,520,1
"6599","28",47,"control",2320,340,180,520,1
"6601","28",49,"control",1141,120,360,480,1
"6602","28",50,"control",1938,280,280,560,1
"6603","28",51,"control",3044,380,100,480,1
"6604","28",52,"control",1128,40,380,420,1
"6605","28",53,"control",1737,300,240,540,1
"6606","28",54,"control",2822,360,160,520,1
"6607","28",55,"control",1118,40,380,420,1
"6608","28",56,"control",2304,360,120,480,1
"6609","28",57,"control",2390,360,160,520,1
"6610","28",58,"multi-motive",1520,380,100,480,1
"6611","28",59,"multi-motive",1640,40,380,420,1
"6612","28",60,"multi-motive",1805,340,180,520,1
"6613","28",61,"multi-motive",1559,380,20,400,1
"6614","28",62,"multi-motive",2085,380,20,400,0
"6615","28",63,"multi-motive",2875,380,60,440,1
"6616","28",64,"control",1729,380,100,480,1
"6617","28",65,"control",1712,380,20,400,0
"6618","28",66,"control",2164,120,360,480,1
"6619","28",67,"control",1408,160,360,520,1
"6620","28",68,"control",1648,240,300,540,1
"6623","28",71,"multi-motive",1863,280,280,560,1
"6624","28",72,"multi-motive",1293,20,380,400,1
"6625","28",73,"multi-motive",3074,380,40,420,1
"6626","28",74,"multi-motive",1972,320,220,540,1
"6628","28",76,"multi-motive",929,120,360,480,1
"6629","28",77,"multi-motive",1657,100,380,480,1
"6630","28",78,"multi-motive",1910,340,180,520,1
"6631","28",79,"multi-motive",1468,360,160,520,1
"6632","28",80,"multi-motive",1067,60,380,440,1
"6633","28",81,"multi-motive",1895,40,380,420,1
"6634","28",82,"multi-motive",956,160,360,520,1
"6635","28",83,"multi-motive",1809,380,100,480,1
"6636","28",84,"multi-motive",2125,360,160,520,1
"6637","29",1,"control",1151,180,340,520,1
"6638","29",2,"control",778,160,360,520,1
"6640","29",4,"control",669,120,360,480,1
"6642","29",6,"control",993,60,380,440,1
"6643","29",7,"control",816,360,160,520,1
"6644","29",8,"control",1247,280,280,560,1
"6645","29",9,"control",1494,380,40,420,1
"6646","29",10,"control",1044,320,220,540,1
"6647","29",11,"control",775,20,380,400,1
"6648","29",12,"control",1052,100,380,480,1
"6649","29",13,"multi-motive",839,180,340,520,1
"6650","29",14,"multi-motive",992,40,380,420,1
"6651","29",15,"multi-motive",1099,380,100,480,1
"6652","29",16,"control",869,240,300,540,1
"6653","29",17,"control",1166,380,100,480,1
"6654","29",18,"control",1014,240,300,540,1
"6655","29",19,"control",994,300,240,540,1
"6656","29",20,"control",722,220,320,540,1
"6657","29",21,"control",995,340,180,520,1
"6658","29",22,"multi-motive",973,300,240,540,1
"6660","29",24,"multi-motive",983,160,360,520,1
"6661","29",25,"control",1064,380,100,480,1
"6662","29",26,"control",1161,380,40,420,1
"6663","29",27,"control",1307,60,380,440,1
"6664","29",28,"control",1398,40,380,420,1
"6665","29",29,"control",1180,40,380,420,1
"6667","29",31,"multi-motive",1214,240,300,540,1
"6668","29",32,"multi-motive",1294,380,40,420,1
"6669","29",33,"multi-motive",1945,280,280,560,1
"6670","29",34,"multi-motive",1145,360,120,480,1
"6672","29",36,"multi-motive",2696,380,60,440,1
"6673","29",37,"multi-motive",2730,380,40,420,1
"6674","29",38,"multi-motive",1090,220,320,540,1
"6675","29",39,"multi-motive",1232,120,360,480,1
"6676","29",40,"control",917,320,220,540,1
"6677","29",41,"control",1631,380,20,400,1
"6679","29",43,"multi-motive",1548,280,280,560,1
"6680","29",44,"multi-motive",1471,380,20,400,1
"6681","29",45,"multi-motive",1209,100,380,480,1
"6682","29",46,"multi-motive",1191,100,380,480,1
"6683","29",47,"multi-motive",1017,320,220,540,1
"6684","29",48,"multi-motive",1421,20,380,400,1
"6685","29",49,"multi-motive",1012,60,380,440,1
"6687","29",51,"multi-motive",884,380,100,480,1
"6688","29",52,"control",775,20,380,400,1
"6689","29",53,"control",817,340,180,520,1
"6690","29",54,"control",821,220,320,540,1
"6691","29",55,"multi-motive",832,340,180,520,1
"6692","29",56,"multi-motive",710,40,380,420,1
"6693","29",57,"multi-motive",839,220,320,540,1
"6694","29",58,"multi-motive",872,180,340,520,1
"6696","29",60,"multi-motive",839,20,380,400,1
"6697","29",61,"multi-motive",1627,340,180,520,1
"6698","29",62,"multi-motive",1144,360,160,520,1
"6699","29",63,"multi-motive",886,360,160,520,1
"6700","29",64,"control",965,360,120,480,1
"6701","29",65,"control",886,360,120,480,1
"6702","29",66,"control",853,180,340,520,1
"6703","29",67,"multi-motive",1007,320,220,540,1
"6704","29",68,"multi-motive",839,240,300,540,1
"6705","29",69,"multi-motive",1449,360,120,480,1
"6706","29",70,"control",945,380,60,440,1
"6707","29",71,"control",858,380,60,440,1
"6708","29",72,"control",831,280,280,560,1
"6709","29",73,"multi-motive",1012,300,240,540,1
"6710","29",74,"multi-motive",855,380,60,440,1
"6711","29",75,"multi-motive",970,120,360,480,1
"6712","29",76,"control",880,160,360,520,1
"6713","29",77,"control",977,360,160,520,1
"6715","29",79,"multi-motive",892,160,360,520,1
"6716","29",80,"multi-motive",825,60,380,440,1
"6717","29",81,"multi-motive",982,380,20,400,1
"6718","29",82,"control",923,300,240,540,1
"6719","29",83,"control",782,100,380,480,1
"6720","29",84,"control",1214,120,360,480,1
"6721","30",1,"reciprocity",1320,380,20,400,1
"6723","30",3,"reciprocity",1512,60,380,440,0
"6724","30",4,"empathy",1182,280,280,560,1
"6725","30",5,"empathy",1081,360,160,520,1
"6726","30",6,"empathy",1331,280,280,560,1
"6727","30",7,"empathy",890,380,60,440,1
"6728","30",8,"empathy",1269,320,220,540,1
"6729","30",9,"empathy",1101,20,380,400,1
"6730","30",10,"empathy",773,160,360,520,1
"6731","30",11,"empathy",973,320,220,540,1
"6733","30",13,"empathy",1003,100,380,480,1
"6734","30",14,"empathy",733,60,380,440,1
"6736","30",16,"reciprocity",1675,380,40,420,1
"6738","30",18,"reciprocity",1043,180,340,520,0
"6740","30",20,"reciprocity",1283,120,360,480,1
"6741","30",21,"reciprocity",839,20,380,400,1
"6742","30",22,"reciprocity",1430,160,360,520,1
"6743","30",23,"reciprocity",1476,340,180,520,1
"6744","30",24,"reciprocity",1568,380,20,400,0
"6745","30",25,"empathy",803,300,240,540,1
"6746","30",26,"empathy",1455,60,380,440,1
"6747","30",27,"empathy",2042,380,40,420,0
"6748","30",28,"empathy",1546,380,20,400,1
"6749","30",29,"empathy",867,40,380,420,1
"6750","30",30,"empathy",788,360,120,480,1
"6751","30",31,"empathy",989,220,320,540,1
"6752","30",32,"empathy",1338,380,40,420,1
"6753","30",33,"empathy",1352,380,20,400,1
"6754","30",34,"reciprocity",2552,380,100,480,1
"6755","30",35,"reciprocity",867,60,380,440,1
"6756","30",36,"reciprocity",1465,360,160,520,0
"6757","30",37,"empathy",1024,100,380,480,1
"6758","30",38,"empathy",1369,40,380,420,1
"6759","30",39,"empathy",1061,360,120,480,1
"6761","30",41,"reciprocity",630,40,380,420,1
"6762","30",42,"reciprocity",1507,100,380,480,1
"6763","30",43,"reciprocity",1063,320,220,540,1
"6764","30",44,"reciprocity",797,40,380,420,1
"6765","30",45,"reciprocity",1073,240,300,540,1
"6766","30",46,"reciprocity",1145,340,180,520,0
"6767","30",47,"reciprocity",1143,280,280,560,1
"6768","30",48,"reciprocity",1574,360,120,480,1
"6769","30",49,"reciprocity",1884,280,280,560,1
"6770","30",50,"reciprocity",1366,300,240,540,1
"6771","30",51,"reciprocity",784,100,380,480,1
"6772","30",52,"reciprocity",2055,380,60,440,1
"6773","30",53,"reciprocity",1230,180,340,520,1
"6774","30",54,"reciprocity",1728,360,120,480,1
"6775","30",55,"empathy",889,220,320,540,1
"6776","30",56,"empathy",1530,340,180,520,1
"6778","30",58,"reciprocity",1340,380,40,420,0
"6779","30",59,"reciprocity",1972,360,160,520,1
"6780","30",60,"reciprocity",1328,380,100,480,0
"6781","30",61,"empathy",590,180,340,520,1
"6782","30",62,"empathy",923,240,300,540,1
"6783","30",63,"empathy",1504,120,360,480,1
"6784","30",64,"empathy",3655,20,380,400,1
"6785","30",65,"empathy",1115,380,60,440,1
"6786","30",66,"empathy",1017,120,360,480,1
"6787","30",67,"empathy",1601,380,100,480,1
"6788","30",68,"empathy",1001,340,180,520,1
"6790","30",70,"reciprocity",1093,300,240,540,1
"6791","30",71,"reciprocity",1497,220,320,540,1
"6792","30",72,"reciprocity",1949,220,320,540,0
"6794","30",74,"empathy",905,360,160,520,1
"6795","30",75,"empathy",786,180,340,520,1
"6796","30",76,"reciprocity",931,120,360,480,1
"6797","30",77,"reciprocity",1283,240,300,540,1
"6798","30",78,"reciprocity",1101,320,220,540,1
"6799","30",79,"empathy",680,160,360,520,1
"6800","30",80,"empathy",1166,300,240,540,1
"6801","30",81,"empathy",1339,240,300,540,1
"6802","30",82,"reciprocity",1163,380,60,440,1
"6803","30",83,"reciprocity",1969,160,360,520,1
"6804","30",84,"reciprocity",1124,20,380,400,1
"6805","31",1,"empathy",1929,380,20,400,0
"6806","31",2,"empathy",2714,240,300,540,1
"6807","31",3,"empathy",1367,180,340,520,1
"6808","31",4,"reciprocity",977,60,380,440,1
"6809","31",5,"reciprocity",1989,380,20,400,1
"6810","31",6,"reciprocity",2275,360,120,480,0
"6811","31",7,"reciprocity",957,100,380,480,1
"6812","31",8,"reciprocity",1798,160,360,520,1
"6813","31",9,"reciprocity",2322,380,40,420,0
"6814","31",10,"empathy",1705,380,100,480,1
"6815","31",11,"empathy",2043,380,20,400,0
"6816","31",12,"empathy",1621,280,280,560,1
"6817","31",13,"empathy",1884,60,380,440,1
"6818","31",14,"empathy",2589,320,220,540,0
"6819","31",15,"empathy",2314,300,240,540,1
"6820","31",16,"reciprocity",1632,280,280,560,1
"6821","31",17,"reciprocity",1926,180,340,520,1
"6823","31",19,"reciprocity",1899,380,40,420,0
"6824","31",20,"reciprocity",2761,360,160,520,1
"6826","31",22,"empathy",3061,340,180,520,1
"6828","31",24,"empathy",2314,120,360,480,1
"6829","31",25,"reciprocity",2181,100,380,480,1
"6830","31",26,"reciprocity",2217,360,160,520,1
"6831","31",27,"reciprocity",1912,220,320,540,1
"6832","31",28,"reciprocity",2668,380,60,440,1
"6833","31",29,"reciprocity",2207,20,380,400,1
"6834","31",30,"reciprocity",1528,320,220,540,1
"6835","31",31,"empathy",1745,220,320,540,1
"6836","31",32,"empathy",2651,380,60,440,0
"6838","31",34,"reciprocity",1215,220,320,540,1
"6839","31",35,"reciprocity",1927,240,300,540,1
"6840","31",36,"reciprocity",2872,340,180,520,0
"6841","31",37,"reciprocity",2280,380,100,480,1
"6842","31",38,"reciprocity",1712,160,360,520,1
"6843","31",39,"reciprocity",1753,300,240,540,1
"6844","31",40,"empathy",1924,180,340,520,1
"6845","31",41,"empathy",2446,360,160,520,1
"6846","31",42,"empathy",2077,360,120,480,1
"6847","31",43,"reciprocity",2188,340,180,520,0
"6848","31",44,"reciprocity",1939,300,240,540,1
"6849","31",45,"reciprocity",2337,280,280,560,1
"6850","31",46,"reciprocity",3070,380,20,400,0
"6851","31",47,"reciprocity",1006,120,360,480,1
"6852","31",48,"reciprocity",1144,240,300,540,1
"6853","31",49,"empathy",2154,360,120,480,1
"6854","31",50,"empathy",903,320,220,540,1
"6855","31",51,"empathy",1057,300,240,540,1
"6856","31",52,"reciprocity",1384,180,340,520,1
"6857","31",53,"reciprocity",1996,380,100,480,0
"6860","31",56,"empathy",924,20,380,400,1
"6861","31",57,"empathy",1462,20,380,400,1
"6862","31",58,"reciprocity",1435,320,220,540,1
"6864","31",60,"reciprocity",1281,40,380,420,1
"6865","31",61,"empathy",2288,340,180,520,1
"6866","31",62,"empathy",1139,160,360,520,1
"6867","31",63,"empathy",871,40,380,420,1
"6868","31",64,"empathy",956,120,360,480,1
"6869","31",65,"empathy",2257,380,100,480,0
"6870","31",66,"empathy",1143,240,300,540,1
"6871","31",67,"empathy",1762,360,160,520,1
"6872","31",68,"empathy",2196,40,380,420,1
"6873","31",69,"empathy",971,100,380,480,1
"6874","31",70,"empathy",1075,160,360,520,1
"6875","31",71,"empathy",1137,100,380,480,1
"6876","31",72,"empathy",2817,380,40,420,0
"6878","31",74,"empathy",2113,380,60,440,0
"6879","31",75,"empathy",1306,280,280,560,1
"6880","31",76,"reciprocity",845,40,380,420,1
"6881","31",77,"reciprocity",2754,380,60,440,1
"6882","31",78,"reciprocity",1423,120,360,480,1
"6883","31",79,"reciprocity",2292,60,380,440,1
"6884","31",80,"reciprocity",2075,360,120,480,0
"6885","31",81,"reciprocity",928,20,380,400,1
"6886","31",82,"empathy",2536,380,40,420,1
"6887","31",83,"empathy",1479,220,320,540,1
"6888","31",84,"empathy",1064,60,380,440,1
"6889","32",1,"empathy",1563,240,300,540,1
"6890","32",2,"empathy",1644,220,320,540,1
"6891","32",3,"empathy",2711,300,240,540,0
"6892","32",4,"reciprocity",1230,380,60,440,1
"6893","32",5,"reciprocity",1065,20,380,400,1
"6894","32",6,"reciprocity",1294,40,380,420,1
"6895","32",7,"empathy",1028,100,380,480,1
"6896","32",8,"empathy",1042,20,380,400,1
"6898","32",10,"reciprocity",2187,340,180,520,0
"6899","32",11,"reciprocity",1369,180,340,520,1
"6900","32",12,"reciprocity",1163,100,380,480,1
"6901","32",13,"empathy",1204,340,180,520,0
"6902","32",14,"empathy",1541,240,300,540,1
"6903","32",15,"empathy",2764,380,60,440,0
"6904","32",16,"empathy",1137,40,380,420,1
"6905","32",17,"empathy",1295,380,40,420,0
"6906","32",18,"empathy",2086,300,240,540,0
"6907","32",19,"empathy",1224,220,320,540,1
"6908","32",20,"empathy",977,40,380,420,1
"6909","32",21,"empathy",1301,120,360,480,1
"6910","32",22,"empathy",907,100,380,480,1
"6911","32",23,"empathy",2492,360,160,520,0
"6912","32",24,"empathy",897,60,380,440,1
"6913","32",25,"reciprocity",1883,380,40,420,0
"6914","32",26,"reciprocity",763,120,360,480,1
"6915","32",27,"reciprocity",3359,300,240,540,1
"6916","32",28,"reciprocity",3018,320,220,540,1
"6917","32",29,"reciprocity",1993,160,360,520,1
"6918","32",30,"reciprocity",894,60,380,440,1
"6919","32",31,"reciprocity",2412,360,120,480,0
"6921","32",33,"reciprocity",754,240,300,540,1
"6922","32",34,"empathy",1035,320,220,540,0
"6923","32",35,"empathy",839,280,280,560,1
"6924","32",36,"empathy",827,60,380,440,1
"6925","32",37,"reciprocity",1829,380,40,420,0
"6926","32",38,"reciprocity",3374,360,160,520,0
"6928","32",40,"reciprocity",783,20,380,400,1
"6929","32",41,"reciprocity",909,120,360,480,1
"6930","32",42,"reciprocity",1457,360,160,520,0
"6932","32",44,"empathy",963,360,120,480,1
"6933","32",45,"empathy",1977,380,40,420,0
"6934","32",46,"empathy",987,340,180,520,1
"6935","32",47,"empathy",889,280,280,560,1
"6936","32",48,"empathy",773,180,340,520,1
"6937","32",49,"empathy",739,120,360,480,1
"6938","32",50,"empathy",1475,380,100,480,0
"6939","32",51,"empathy",979,180,340,520,1
"6940","32",52,"empathy",758,20,380,400,1
"6941","32",53,"empathy",1704,380,100,480,0
"6942","32",54,"empathy",2230,360,120,480,0
"6943","32",55,"reciprocity",1387,360,120,480,0
"6945","32",57,"reciprocity",2823,380,60,440,0
"6946","32",58,"reciprocity",2671,280,280,560,1
"6947","32",59,"reciprocity",2752,300,240,540,1
"6948","32",60,"reciprocity",1342,240,300,540,1
"6949","32",61,"empathy",1048,160,360,520,1
"6950","32",62,"empathy",1846,380,60,440,0
"6951","32",63,"empathy",962,160,360,520,1
"6952","32",64,"reciprocity",1687,340,180,520,0
"6953","32",65,"reciprocity",1650,380,20,400,1
"6955","32",67,"empathy",1965,380,20,400,0
"6956","32",68,"empathy",1252,360,160,520,0
"6958","32",70,"reciprocity",998,180,340,520,1
"6959","32",71,"reciprocity",1871,160,360,520,1
"6960","32",72,"reciprocity",1909,380,100,480,0
"6961","32",73,"reciprocity",2351,220,320,540,1
"6962","32",74,"reciprocity",1979,280,280,560,1
"6963","32",75,"reciprocity",2716,320,220,540,1
"6964","32",76,"empathy",839,320,220,540,1
"6966","32",78,"empathy",2179,380,20,400,0
"6967","32",79,"reciprocity",1719,100,380,480,1
"6968","32",80,"reciprocity",2466,380,100,480,0
"6969","32",81,"reciprocity",1089,380,20,400,0
"6970","32",82,"reciprocity",780,60,380,440,1
"6971","32",83,"reciprocity",1172,40,380,420,1
"6972","32",84,"reciprocity",866,220,320,540,1
