ID;trialno;condition;rt;self_poss_loss;other_poss_gain;diff_diff;resp_code
1;1;control;1913;320;220;540;1
1;2;control;1661;380;20;400;1
1;3;control;1487;240;300;540;0
1;4;control;1402;380;20;400;0
1;5;control;2200;100;380;480;0
1;6;control;2223;220;320;540;1
1;7;multi-motive;1327;340;180;520;1
1;8;multi-motive;1344;300;240;540;1
1;9;multi-motive;1106;380;60;440;1
1;10;control;2155;380;40;420;0
1;11;control;1387;100;380;480;1
1;13;multi-motive;1423;380;100;480;1
1;14;multi-motive;2264;380;40;420;1
1;16;control;1215;220;320;540;1
1;18;control;1597;380;60;440;1
1;19;control;1264;180;340;520;0
1;20;control;1678;380;100;480;1
1;21;control;1021;300;240;540;1
1;22;control;2079;380;100;480;1
1;23;control;967;20;380;400;1
1;24;control;2007;60;380;440;0
1;25;control;1060;180;340;520;1
1;26;control;1244;360;160;520;1
1;27;control;1264;320;220;540;0
1;29;control;1158;120;360;480;0
1;30;control;1207;360;160;520;0
1;31;multi-motive;910;100;380;480;1
1;32;multi-motive;1098;380;60;440;1
1;33;multi-motive;1243;180;340;520;1
1;34;control;1402;340;180;520;1
1;36;control;1543;160;360;520;0
1;37;multi-motive;1021;220;320;540;1
1;38;multi-motive;1142;380;40;420;1
1;39;multi-motive;1003;20;380;400;1
1;41;multi-motive;1386;60;380;440;1
1;43;control;1433;240;300;540;1
1;44;control;1311;120;360;480;1
1;45;control;1017;40;380;420;0
1;46;multi-motive;1155;240;300;540;1
1;47;multi-motive;884;360;120;480;1
1;48;multi-motive;805;280;280;560;1
1;49;multi-motive;707;380;20;400;1
1;50;multi-motive;1236;180;340;520;1
1;51;multi-motive;969;320;220;540;1
1;53;multi-motive;1816;40;380;420;1
1;54;multi-motive;2106;300;240;540;1
1;55;multi-motive;953;40;380;420;1
1;56;multi-motive;1446;380;20;400;1
1;57;multi-motive;1072;280;280;560;1
1;58;multi-motive;1270;20;380;400;1
1;59;multi-motive;1082;60;380;440;1
1;60;multi-motive;869;320;220;540;1
1;61;multi-motive;904;240;300;540;1
1;62;multi-motive;1020;340;180;520;1
1;63;multi-motive;960;220;320;540;1
1;64;multi-motive;791;160;360;520;1
1;65;multi-motive;1269;360;120;480;1
1;66;multi-motive;832;120;360;480;1
1;67;multi-motive;2110;360;160;520;1
1;68;multi-motive;1079;360;160;520;1
1;69;multi-motive;856;380;100;480;1
1;70;control;1855;280;280;560;1
1;71;control;1020;360;120;480;0
1;72;control;1149;60;380;440;1
1;73;control;989;280;280;560;0
1;74;control;1090;300;240;540;0
1;75;control;1417;160;360;520;1
1;76;multi-motive;1450;120;360;480;1
1;77;multi-motive;842;100;380;480;1
1;78;multi-motive;1764;160;360;520;1
1;79;control;1105;40;380;420;1
1;80;control;1098;20;380;400;0
1;81;control;1256;360;120;480;0
1;82;control;835;380;40;420;1
1;83;control;883;380;60;440;0
1;84;control;834;340;180;520;1
2;1;reciprocity;1149;240;300;540;0
2;2;reciprocity;1422;160;360;520;1
2;3;reciprocity;1387;100;380;480;1
2;4;empathy;1875;100;380;480;0
2;5;empathy;2665;380;60;440;1
2;6;empathy;1413;160;360;520;1
2;7;empathy;2510;120;360;480;0
2;8;empathy;1386;380;20;400;1
2;9;empathy;1747;280;280;560;1
2;10;reciprocity;1877;380;40;420;1
2;11;reciprocity;2618;340;180;520;1
2;12;reciprocity;2671;360;120;480;0
2;13;reciprocity;1392;40;380;420;1
2;14;reciprocity;1276;60;380;440;1
2;16;empathy;1478;40;380;420;1
2;17;empathy;2766;280;280;560;1
2;18;empathy;1838;380;100;480;0
2;19;reciprocity;2102;340;180;520;0
2;20;reciprocity;1316;20;380;400;1
2;21;reciprocity;2610;60;380;440;0
2;22;reciprocity;3011;220;320;540;1
2;23;reciprocity;2191;380;60;440;0
2;24;reciprocity;2240;40;380;420;0
2;25;reciprocity;1660;380;60;440;0
2;26;reciprocity;3793;380;40;420;0
2;27;reciprocity;2063;360;160;520;0
2;28;reciprocity;1767;240;300;540;1
2;29;reciprocity;2123;380;20;400;0
2;30;reciprocity;2334;380;20;400;1
2;31;empathy;2453;360;160;520;1
2;32;empathy;3031;380;40;420;1
2;33;empathy;2886;360;120;480;1
2;34;empathy;2376;160;360;520;0
2;35;empathy;3319;120;360;480;0
2;36;empathy;2372;380;40;420;1
2;37;reciprocity;1923;380;100;480;1
2;38;reciprocity;2653;380;100;480;1
2;40;empathy;2257;60;380;440;1
2;41;empathy;1659;320;220;540;1
2;43;empathy;1788;20;380;400;1
2;44;empathy;2022;220;320;540;0
2;45;empathy;1127;320;220;540;1
2;46;reciprocity;1456;120;360;480;1
2;47;reciprocity;1721;280;280;560;1
2;48;reciprocity;3302;180;340;520;1
2;49;reciprocity;1293;160;360;520;1
2;51;reciprocity;2482;300;240;540;1
2;52;reciprocity;2502;180;340;520;1
2;53;reciprocity;1627;360;160;520;0
2;54;reciprocity;1530;280;280;560;1
2;55;empathy;1812;360;160;520;1
2;57;empathy;1841;180;340;520;1
2;58;empathy;1807;340;180;520;1
2;60;empathy;3249;240;300;540;0
2;61;reciprocity;2638;360;120;480;0
2;63;reciprocity;1521;220;320;540;1
2;64;empathy;1592;100;380;480;1
2;65;empathy;1325;60;380;440;1
2;66;empathy;2736;380;100;480;1
2;67;empathy;2472;40;380;420;1
2;68;empathy;2366;180;340;520;1
2;69;empathy;1017;380;60;440;0
2;70;reciprocity;2071;300;240;540;0
2;71;reciprocity;2022;20;380;400;1
2;72;reciprocity;1687;320;220;540;1
2;73;empathy;1919;240;300;540;0
2;74;empathy;1204;20;380;400;1
2;76;empathy;1717;300;240;540;1
2;77;empathy;1995;380;20;400;1
2;78;empathy;1981;360;120;480;1
2;79;empathy;2163;220;320;540;1
2;80;empathy;1941;300;240;540;1
2;81;empathy;1927;340;180;520;0
2;82;reciprocity;2455;100;380;480;1
2;83;reciprocity;1793;120;360;480;1
2;84;reciprocity;1697;320;220;540;1
3;1;reciprocity;1656;380;100;480;0
3;2;reciprocity;1852;180;340;520;0
3;3;reciprocity;1704;60;380;440;1
3;4;empathy;1929;60;380;440;1
3;5;empathy;1609;120;360;480;1
3;6;empathy;1876;340;180;520;0
3;7;reciprocity;1999;160;360;520;0
3;8;reciprocity;2438;20;380;400;1
3;9;reciprocity;2093;240;300;540;1
3;10;reciprocity;2118;320;220;540;1
3;11;reciprocity;2004;380;20;400;0
3;12;reciprocity;1821;360;160;520;0
3;13;reciprocity;1556;20;380;400;1
3;14;reciprocity;1848;280;280;560;0
3;15;reciprocity;1425;40;380;420;1
3;16;empathy;1017;60;380;440;1
3;17;empathy;1831;320;220;540;1
3;18;empathy;2213;380;100;480;0
3;19;reciprocity;2252;380;60;440;0
3;20;reciprocity;2507;380;60;440;0
3;22;reciprocity;1659;380;20;400;0
3;23;reciprocity;2031;340;180;520;0
3;24;reciprocity;1935;220;320;540;0
3;25;reciprocity;1103;380;40;420;0
3;26;reciprocity;1098;360;120;480;0
3;27;reciprocity;1503;100;380;480;0
3;28;empathy;1697;240;300;540;1
3;29;empathy;1884;280;280;560;1
3;30;empathy;1697;40;380;420;1
3;31;reciprocity;1617;240;300;540;0
3;32;reciprocity;2407;40;380;420;1
3;33;reciprocity;1463;340;180;520;0
3;34;empathy;2004;300;240;540;0
3;35;empathy;1933;280;280;560;1
3;36;empathy;1385;380;100;480;0
3;37;empathy;2083;180;340;520;0
3;39;empathy;1735;380;60;440;0
3;40;empathy;1806;360;160;520;0
3;41;empathy;2537;360;160;520;1
3;42;empathy;1744;360;120;480;0
3;43;empathy;1787;320;220;540;0
3;45;empathy;1873;160;360;520;1
3;47;reciprocity;2109;120;360;480;0
3;48;reciprocity;2053;280;280;560;1
3;49;empathy;1649;380;40;420;0
3;50;empathy;2390;100;380;480;1
3;52;empathy;1149;380;60;440;0
3;53;empathy;1702;360;120;480;1
3;54;empathy;1401;180;340;520;1
3;55;reciprocity;1446;120;360;480;1
3;56;reciprocity;2058;360;160;520;0
3;57;reciprocity;2041;160;360;520;0
3;59;empathy;949;300;240;540;0
3;60;empathy;2062;120;360;480;0
3;61;reciprocity;1905;320;220;540;0
3;62;reciprocity;2134;60;380;440;1
3;63;reciprocity;1308;380;100;480;0
3;64;reciprocity;1962;360;120;480;0
3;66;reciprocity;1584;300;240;540;0
3;68;empathy;1464;20;380;400;1
3;69;empathy;885;40;380;420;1
3;70;empathy;1182;380;40;420;0
3;71;empathy;1370;340;180;520;0
3;72;empathy;1423;380;20;400;0
3;73;empathy;1358;100;380;480;1
3;74;empathy;1142;160;360;520;1
3;75;empathy;2039;240;300;540;0
3;76;empathy;1196;220;320;540;0
3;77;empathy;1095;380;20;400;0
3;78;empathy;2412;20;380;400;1
3;79;reciprocity;2120;180;340;520;1
3;80;reciprocity;1829;380;40;420;0
3;81;reciprocity;3128;220;320;540;1
3;84;reciprocity;2054;300;240;540;1
4;1;multi-motive;1494;20;380;400;1
4;2;multi-motive;2783;380;60;440;0
4;4;control;1140;280;280;560;1
4;5;control;933;120;360;480;1
4;6;control;2124;180;340;520;1
4;7;multi-motive;1700;160;360;520;1
4;8;multi-motive;1397;20;380;400;1
4;9;multi-motive;2161;380;100;480;0
4;10;multi-motive;1260;360;160;520;1
4;11;multi-motive;1271;240;300;540;1
4;12;multi-motive;1446;220;320;540;1
4;13;multi-motive;1868;40;380;420;1
4;14;multi-motive;1576;360;120;480;0
4;15;multi-motive;911;120;360;480;1
4;16;control;1337;20;380;400;1
4;17;control;1207;360;120;480;1
4;18;control;1013;40;380;420;1
4;20;control;2631;380;100;480;1
4;21;control;859;360;160;520;1
4;22;multi-motive;925;300;240;540;1
4;23;multi-motive;824;340;180;520;1
4;24;multi-motive;909;280;280;560;1
4;25;multi-motive;1011;380;40;420;1
4;26;multi-motive;886;380;60;440;1
4;27;multi-motive;939;360;120;480;1
4;28;multi-motive;937;40;380;420;1
4;29;multi-motive;2087;320;220;540;1
4;30;multi-motive;1910;380;100;480;0
4;31;multi-motive;3541;380;20;400;0
4;33;multi-motive;3283;100;380;480;1
4;34;control;2416;380;40;420;0
4;35;control;1795;100;380;480;1
4;36;control;2853;380;100;480;1
4;37;control;1572;120;360;480;1
4;38;control;2563;380;20;400;0
4;39;control;1584;380;60;440;0
4;42;multi-motive;1390;180;340;520;1
4;44;control;2540;240;300;540;1
4;45;control;1811;220;320;540;0
4;46;multi-motive;2341;160;360;520;1
4;47;multi-motive;2403;240;300;540;1
4;48;multi-motive;2960;380;40;420;0
4;49;multi-motive;3327;340;180;520;0
4;50;multi-motive;2284;280;280;560;1
4;51;multi-motive;1972;220;320;540;1
4;52;control;1617;60;380;440;1
4;53;control;2860;340;180;520;0
4;56;control;1839;220;320;540;1
4;57;control;2919;320;220;540;1
4;58;control;2999;300;240;540;1
4;60;control;2763;160;360;520;1
4;61;control;3912;240;300;540;0
4;62;control;1049;40;380;420;1
4;63;control;2441;360;160;520;0
4;64;multi-motive;2141;320;220;540;1
4;65;multi-motive;1217;100;380;480;1
4;66;multi-motive;1309;120;360;480;1
4;68;multi-motive;2427;380;20;400;0
4;69;multi-motive;1313;60;380;440;1
4;70;control;1381;280;280;560;1
4;71;control;3185;300;240;540;0
4;72;control;861;60;380;440;1
4;73;control;1642;340;180;520;1
4;74;control;1520;320;220;540;0
4;75;control;1803;20;380;400;1
4;76;control;1248;380;40;420;0
4;77;control;1209;380;20;400;0
4;78;control;1227;160;360;520;1
4;79;multi-motive;1326;360;160;520;0
4;80;multi-motive;2148;300;240;540;1
4;81;multi-motive;1229;60;380;440;1
4;82;control;1584;380;60;440;0
4;83;control;994;100;380;480;1
4;84;control;1840;360;120;480;0
5;2;control;2370;100;380;480;1
5;4;control;2806;280;280;560;1
5;7;control;3507;240;300;540;1
5;8;control;3571;40;380;420;1
5;9;control;2237;120;360;480;1
5;10;control;2785;60;380;440;1
5;11;control;2821;380;40;420;1
5;12;control;1470;340;180;520;1
5;13;multi-motive;2101;40;380;420;1
5;14;multi-motive;1409;220;320;540;1
5;15;multi-motive;2669;380;40;420;1
5;16;multi-motive;964;180;340;520;1
5;17;multi-motive;1785;300;240;540;1
5;18;multi-motive;1314;380;40;420;1
5;19;multi-motive;1197;340;180;520;1
5;20;multi-motive;1549;180;340;520;1
5;21;multi-motive;1408;320;220;540;1
5;22;multi-motive;1053;280;280;560;1
5;23;multi-motive;1275;60;380;440;1
5;24;multi-motive;1539;280;280;560;1
5;25;multi-motive;842;160;360;520;1
5;26;multi-motive;1219;160;360;520;1
5;28;control;1176;360;160;520;1
5;30;control;906;20;380;400;1
5;31;control;1141;320;220;540;1
5;32;control;1322;340;180;520;1
5;33;control;1014;220;320;540;1
5;34;multi-motive;1097;380;100;480;1
5;35;multi-motive;1059;20;380;400;1
5;36;multi-motive;915;360;120;480;1
5;37;multi-motive;1027;40;380;420;1
5;38;multi-motive;1074;100;380;480;1
5;39;multi-motive;1954;20;380;400;1
5;40;multi-motive;1870;120;360;480;1
5;41;multi-motive;1933;380;60;440;1
5;42;multi-motive;2034;380;100;480;1
5;43;multi-motive;1319;300;240;540;1
5;44;multi-motive;1116;340;180;520;1
5;45;multi-motive;1943;360;160;520;1
5;46;control;1803;220;320;540;1
5;47;control;1912;20;380;400;1
5;48;control;1754;320;220;540;1
5;49;control;2008;60;380;440;1
5;50;control;1088;280;280;560;1
5;51;control;796;380;100;480;1
5;52;multi-motive;1335;100;380;480;1
5;53;multi-motive;1502;360;120;480;1
5;55;control;1847;160;360;520;1
5;56;control;1107;120;360;480;1
5;57;control;2220;380;60;440;1
5;58;multi-motive;1038;240;300;540;1
5;59;multi-motive;823;120;360;480;1
5;60;multi-motive;1193;380;20;400;1
5;62;multi-motive;924;60;380;440;1
5;63;multi-motive;838;360;160;520;1
5;64;control;1157;300;240;540;1
5;65;control;1186;40;380;420;1
5;66;control;692;240;300;540;1
5;67;control;689;180;340;520;1
5;68;control;902;100;380;480;1
5;69;control;1007;380;60;440;1
5;70;control;731;360;120;480;1
5;72;control;1591;160;360;520;1
5;73;control;901;180;340;520;1
5;74;control;1681;380;100;480;1
5;75;control;797;380;40;420;1
5;76;control;1931;380;20;400;1
5;77;control;938;380;20;400;1
5;78;control;808;300;240;540;1
5;79;multi-motive;1015;220;320;540;1
5;80;multi-motive;2294;380;20;400;1
5;81;multi-motive;1305;320;220;540;1
5;83;multi-motive;1548;380;60;440;1
5;84;multi-motive;972;240;300;540;1
6;1;multi-motive;1926;380;40;420;1
6;2;multi-motive;2379;240;300;540;1
6;4;multi-motive;1658;280;280;560;1
6;5;multi-motive;2093;280;280;560;1
6;6;multi-motive;1873;320;220;540;1
6;7;control;1982;300;240;540;1
6;8;control;1556;340;180;520;1
6;9;control;1998;280;280;560;1
6;10;multi-motive;2126;360;160;520;1
6;11;multi-motive;1637;20;380;400;1
6;12;multi-motive;1917;180;340;520;1
6;14;control;1087;180;340;520;1
6;15;control;1821;240;300;540;1
6;16;control;1993;380;40;420;1
6;17;control;1757;380;100;480;1
6;18;control;1465;120;360;480;1
6;19;control;1333;320;220;540;1
6;20;control;1104;40;380;420;1
6;21;control;2438;380;60;440;1
6;23;control;1756;220;320;540;1
6;24;control;2405;380;20;400;0
6;25;control;1364;240;300;540;1
6;26;control;1123;280;280;560;1
6;27;control;1472;120;360;480;1
6;28;control;3491;360;160;520;0
6;29;control;1047;20;380;400;1
6;30;control;2013;340;180;520;1
6;31;control;2050;160;360;520;1
6;32;control;2576;380;20;400;1
6;33;control;2783;360;160;520;1
6;34;control;2749;360;120;480;0
6;35;control;1206;100;380;480;1
6;36;control;1194;40;380;420;1
6;37;multi-motive;2824;160;360;520;1
6;38;multi-motive;1753;220;320;540;1
6;39;multi-motive;3054;380;40;420;0
6;40;multi-motive;1047;100;380;480;1
6;41;multi-motive;2064;300;240;540;1
6;42;multi-motive;3351;380;60;440;0
6;44;multi-motive;2187;20;380;400;1
6;45;multi-motive;1090;60;380;440;1
6;46;control;2422;320;220;540;1
6;47;control;2089;360;120;480;1
6;48;control;1680;220;320;540;1
6;49;multi-motive;2722;340;180;520;1
6;50;multi-motive;1822;220;320;540;1
6;51;multi-motive;2654;380;20;400;0
6;52;multi-motive;869;40;380;420;1
6;53;multi-motive;1789;360;160;520;1
6;54;multi-motive;1305;180;340;520;1
6;55;control;2033;380;40;420;0
6;56;control;1491;300;240;540;1
6;57;control;1084;60;380;440;1
6;58;control;882;160;360;520;1
6;59;control;1349;100;380;480;1
6;61;control;2228;380;60;440;0
6;62;control;2089;380;100;480;1
6;64;control;1062;60;380;440;1
6;65;control;1609;180;340;520;1
6;66;control;1157;20;380;400;1
6;67;multi-motive;995;100;380;480;1
6;69;multi-motive;2168;360;120;480;1
6;70;multi-motive;1811;300;240;540;1
6;71;multi-motive;1078;120;360;480;1
6;72;multi-motive;2435;380;20;400;0
6;73;multi-motive;1534;160;360;520;1
6;74;multi-motive;2202;320;220;540;1
6;75;multi-motive;1653;240;300;540;1
6;76;multi-motive;1141;60;380;440;1
6;77;multi-motive;1532;40;380;420;1
6;78;multi-motive;2104;120;360;480;1
6;80;multi-motive;2542;380;100;480;1
6;81;multi-motive;1425;340;180;520;1
6;82;multi-motive;2636;380;60;440;0
6;83;multi-motive;3743;360;120;480;1
6;84;multi-motive;1485;380;100;480;1
7;1;multi-motive;2366;320;220;540;1
7;2;multi-motive;1609;20;380;400;1
7;3;multi-motive;1140;100;380;480;1
7;4;control;1719;380;40;420;0
7;5;control;2209;320;220;540;1
7;6;control;1497;360;120;480;0
7;7;multi-motive;2438;40;380;420;0
7;8;multi-motive;2121;380;100;480;0
7;9;multi-motive;2000;360;120;480;0
7;10;control;1512;100;380;480;1
7;11;control;1174;40;380;420;1
7;12;control;1913;380;20;400;0
7;13;control;1598;160;360;520;1
7;14;control;2062;340;180;520;0
7;16;multi-motive;1992;360;120;480;1
7;17;multi-motive;1885;380;40;420;0
7;19;multi-motive;1383;280;280;560;1
7;20;multi-motive;2001;380;20;400;0
7;21;multi-motive;1187;240;300;540;1
7;22;control;1708;320;220;540;1
7;23;control;2259;160;360;520;0
7;24;control;1397;60;380;440;1
7;25;control;1625;380;40;420;0
7;28;control;1336;380;60;440;0
7;29;control;2244;300;240;540;1
7;30;control;2411;380;100;480;0
7;31;control;1884;180;340;520;1
7;32;control;1805;380;100;480;0
7;33;control;2026;40;380;420;1
7;34;control;1691;380;60;440;0
7;35;control;1943;240;300;540;1
7;36;control;2363;280;280;560;1
7;37;control;2141;100;380;480;1
7;38;control;1820;220;320;540;1
7;40;control;1438;20;380;400;1
7;41;control;1058;20;380;400;1
7;42;control;1764;360;160;520;0
7;43;multi-motive;1217;120;360;480;1
7;44;multi-motive;2089;360;160;520;0
7;46;control;1447;120;360;480;1
7;47;control;1135;380;20;400;0
7;48;control;1903;180;340;520;1
7;49;multi-motive;1349;240;300;540;0
7;50;multi-motive;1432;380;100;480;0
7;51;multi-motive;1690;280;280;560;1
7;52;control;1797;60;380;440;1
7;53;control;1391;240;300;540;1
7;54;control;1795;340;180;520;0
7;55;multi-motive;1660;380;60;440;0
7;56;multi-motive;1223;160;360;520;1
7;57;multi-motive;1172;40;380;420;1
7;58;control;1395;280;280;560;1
7;59;control;2022;120;360;480;1
7;60;control;1568;360;160;520;0
7;61;control;1754;220;320;540;1
7;62;control;1506;300;240;540;0
7;63;control;1624;360;120;480;0
7;64;multi-motive;1563;180;340;520;1
7;65;multi-motive;2174;360;160;520;1
7;66;multi-motive;1700;220;320;540;1
7;67;multi-motive;1395;60;380;440;1
7;68;multi-motive;1778;120;360;480;1
7;69;multi-motive;2248;380;20;400;0
7;70;multi-motive;1350;180;340;520;1
7;71;multi-motive;883;20;380;400;1
7;73;multi-motive;2046;380;40;420;0
7;74;multi-motive;1378;300;240;540;1
7;75;multi-motive;2312;340;180;520;1
7;76;multi-motive;1252;160;360;520;1
7;78;multi-motive;1517;340;180;520;0
7;79;multi-motive;1984;300;240;540;0
7;80;multi-motive;2117;220;320;540;1
7;81;multi-motive;1300;100;380;480;1
7;82;multi-motive;1594;380;60;440;0
7;83;multi-motive;2448;320;220;540;1
7;84;multi-motive;1607;60;380;440;1
8;1;empathy;2417;320;220;540;0
8;2;empathy;3016;40;380;420;1
8;3;empathy;2723;120;360;480;1
8;5;empathy;2544;380;40;420;0
8;6;empathy;3186;380;60;440;0
8;7;empathy;2170;60;380;440;1
8;8;empathy;1834;20;380;400;1
8;9;empathy;1504;100;380;480;1
8;10;reciprocity;1788;380;20;400;0
8;11;reciprocity;1749;40;380;420;1
8;12;reciprocity;2030;380;40;420;0
8;13;empathy;2035;380;20;400;0
8;14;empathy;2306;40;380;420;1
8;15;empathy;1618;320;220;540;1
8;16;empathy;2211;240;300;540;0
8;17;empathy;1627;180;340;520;1
8;18;empathy;1959;360;160;520;1
8;19;reciprocity;2258;100;380;480;0
8;20;reciprocity;1846;300;240;540;1
8;21;reciprocity;1429;120;360;480;1
8;22;empathy;1503;100;380;480;1
8;23;empathy;1234;300;240;540;1
8;24;empathy;2481;380;100;480;1
8;25;empathy;1610;160;360;520;0
8;26;empathy;2324;360;120;480;0
8;27;empathy;1906;220;320;540;1
8;30;reciprocity;1591;340;180;520;0
8;31;reciprocity;2272;160;360;520;0
8;32;reciprocity;1285;360;120;480;0
8;33;reciprocity;1917;280;280;560;0
8;34;reciprocity;1828;60;380;440;0
8;35;reciprocity;1603;180;340;520;0
8;36;reciprocity;2503;380;100;480;1
8;37;reciprocity;2024;180;340;520;1
8;38;reciprocity;1528;60;380;440;1
8;39;reciprocity;2367;320;220;540;0
8;40;empathy;2582;340;180;520;1
8;41;empathy;1726;60;380;440;1
8;42;empathy;1938;380;40;420;0
8;43;empathy;2359;360;120;480;0
8;44;empathy;2221;220;320;540;1
8;45;empathy;1701;20;380;400;1
8;46;reciprocity;2313;240;300;540;0
8;47;reciprocity;2185;380;40;420;0
8;48;reciprocity;2596;20;380;400;1
8;49;reciprocity;2693;380;100;480;0
8;50;reciprocity;2349;300;240;540;1
8;51;reciprocity;1955;380;60;440;0
8;52;empathy;2679;180;340;520;1
8;53;empathy;2440;240;300;540;1
8;54;empathy;2069;380;20;400;0
8;55;reciprocity;2456;40;380;420;1
8;56;reciprocity;2268;240;300;540;1
8;57;reciprocity;2079;280;280;560;0
8;58;reciprocity;2337;160;360;520;1
8;59;reciprocity;1897;360;160;520;1
8;60;reciprocity;2499;340;180;520;0
8;61;reciprocity;1995;380;20;400;0
8;62;reciprocity;2716;320;220;540;1
8;63;reciprocity;2579;360;120;480;0
8;64;empathy;2947;280;280;560;0
8;65;empathy;1964;360;160;520;1
8;66;empathy;2410;280;280;560;1
8;67;empathy;2856;380;60;440;0
8;68;empathy;2299;120;360;480;1
8;69;empathy;3636;380;100;480;0
8;71;empathy;2805;160;360;520;1
8;73;reciprocity;2146;20;380;400;1
8;74;reciprocity;1830;360;160;520;0
8;75;reciprocity;2578;100;380;480;1
8;77;reciprocity;1753;380;60;440;0
8;78;reciprocity;2952;220;320;540;0
8;79;reciprocity;2342;220;320;540;1
8;80;reciprocity;2756;120;360;480;1
8;82;empathy;2430;300;240;540;0
8;83;empathy;2381;340;180;520;0
9;1;reciprocity;1995;380;20;400;0
9;2;reciprocity;1846;380;100;480;0
9;3;reciprocity;1195;220;320;540;1
9;4;empathy;1062;360;160;520;0
9;5;empathy;1147;280;280;560;1
9;6;empathy;1598;180;340;520;1
9;7;empathy;1558;160;360;520;1
9;8;empathy;1896;280;280;560;0
9;9;empathy;1261;20;380;400;1
9;10;reciprocity;1255;240;300;540;1
9;11;reciprocity;1723;320;220;540;1
9;12;reciprocity;1058;100;380;480;1
9;13;reciprocity;2652;360;160;520;1
9;15;reciprocity;1814;60;380;440;1
9;16;empathy;1508;240;300;540;0
9;17;empathy;1892;380;20;400;0
9;18;empathy;2171;380;40;420;0
9;19;empathy;1251;100;380;480;1
9;20;empathy;1052;40;380;420;1
9;21;empathy;1600;180;340;520;1
9;22;empathy;1122;360;120;480;0
9;23;empathy;1521;40;380;420;1
9;24;empathy;1223;380;100;480;1
9;25;reciprocity;1733;280;280;560;1
9;26;reciprocity;755;380;40;420;0
9;27;reciprocity;1503;340;180;520;0
9;28;empathy;1121;360;160;520;0
9;31;reciprocity;1507;40;380;420;1
9;32;reciprocity;1415;360;120;480;1
9;33;reciprocity;1492;180;340;520;1
9;34;reciprocity;1705;180;340;520;0
9;35;reciprocity;1031;380;20;400;0
9;36;reciprocity;1299;360;120;480;0
9;37;empathy;1272;220;320;540;0
9;38;empathy;1344;120;360;480;1
9;39;empathy;1346;380;60;440;0
9;40;empathy;1468;20;380;400;1
9;41;empathy;1102;160;360;520;1
9;42;empathy;1544;120;360;480;1
9;43;reciprocity;1830;380;60;440;0
9;44;reciprocity;1280;240;300;540;0
9;45;reciprocity;2004;340;180;520;0
9;46;reciprocity;1299;20;380;400;1
9;47;reciprocity;1908;320;220;540;0
9;48;reciprocity;868;100;380;480;1
9;49;reciprocity;2202;160;360;520;1
9;50;reciprocity;1522;280;280;560;1
9;52;empathy;1041;380;20;400;0
9;53;empathy;2105;360;120;480;0
9;54;empathy;1025;340;180;520;0
9;55;reciprocity;941;120;360;480;1
9;57;reciprocity;1481;380;100;480;0
9;58;empathy;2031;240;300;540;1
9;59;empathy;1518;60;380;440;0
9;60;empathy;1067;380;60;440;0
9;61;reciprocity;1858;120;360;480;1
9;62;reciprocity;1713;380;40;420;0
9;63;reciprocity;921;160;360;520;1
9;64;reciprocity;1739;300;240;540;1
9;65;reciprocity;1685;380;60;440;0
9;66;reciprocity;1465;60;380;440;1
9;67;empathy;1332;60;380;440;1
9;68;empathy;1039;100;380;480;1
9;69;empathy;799;300;240;540;0
9;70;empathy;928;220;320;540;1
9;71;empathy;1979;300;240;540;1
9;74;reciprocity;2023;360;160;520;1
9;75;reciprocity;1129;220;320;540;1
9;76;empathy;1233;380;100;480;0
9;77;empathy;919;320;220;540;0
9;78;empathy;1941;320;220;540;1
9;79;reciprocity;859;20;380;400;1
9;80;reciprocity;926;40;380;420;1
9;81;reciprocity;1197;300;240;540;0
9;83;empathy;2249;340;180;520;0
9;84;empathy;974;380;40;420;0
10;1;empathy;2603;120;360;480;1
10;2;empathy;3060;360;120;480;1
10;3;empathy;3315;360;160;520;1
10;5;empathy;2615;380;100;480;1
10;6;empathy;1309;100;380;480;1
10;7;reciprocity;2430;320;220;540;1
10;8;reciprocity;1612;20;380;400;1
10;10;reciprocity;2383;240;300;540;1
10;11;reciprocity;3381;380;60;440;0
10;13;reciprocity;2224;100;380;480;1
10;14;reciprocity;3196;360;120;480;1
10;15;reciprocity;3495;300;240;540;1
10;16;empathy;2993;160;360;520;1
10;17;empathy;2123;380;60;440;0
10;18;empathy;1175;240;300;540;1
10;19;empathy;1331;40;380;420;1
10;20;empathy;1692;220;320;540;1
10;22;empathy;3454;320;220;540;1
10;23;empathy;2171;300;240;540;1
10;24;empathy;2627;300;240;540;1
10;25;empathy;2920;380;100;480;0
10;26;empathy;3621;380;40;420;0
10;27;empathy;889;160;360;520;1
10;28;reciprocity;1420;360;160;520;1
10;29;reciprocity;1448;160;360;520;1
10;30;reciprocity;811;120;360;480;1
10;31;reciprocity;1211;320;220;540;1
10;33;reciprocity;918;180;340;520;1
10;34;empathy;1436;40;380;420;1
10;35;empathy;721;20;380;400;1
10;36;empathy;3102;380;20;400;0
10;37;empathy;1699;360;160;520;1
10;38;empathy;974;280;280;560;1
10;39;empathy;3380;340;180;520;1
10;40;reciprocity;2906;380;20;400;0
10;41;reciprocity;989;20;380;400;1
10;42;reciprocity;1089;280;280;560;1
10;43;empathy;888;100;380;480;1
10;44;empathy;2150;120;360;480;1
10;45;empathy;1067;20;380;400;1
10;46;reciprocity;741;220;320;540;1
10;47;reciprocity;2798;380;20;400;0
10;48;reciprocity;1272;280;280;560;1
10;49;empathy;815;60;380;440;1
10;50;empathy;1200;180;340;520;1
10;51;empathy;2509;360;120;480;1
10;53;empathy;2257;220;320;540;1
10;54;empathy;1125;60;380;440;1
10;55;empathy;2048;340;180;520;1
10;56;empathy;2291;380;40;420;0
10;58;reciprocity;1369;160;360;520;1
10;59;reciprocity;743;60;380;440;1
10;60;reciprocity;985;120;360;480;1
10;61;reciprocity;1081;40;380;420;1
10;62;reciprocity;932;220;320;540;1
10;63;reciprocity;880;100;380;480;1
10;64;reciprocity;734;40;380;420;1
10;65;reciprocity;907;240;300;540;1
10;66;reciprocity;2087;380;100;480;1
10;67;reciprocity;1198;180;340;520;1
10;68;reciprocity;3109;380;60;440;0
10;69;reciprocity;1567;380;100;480;1
10;70;empathy;1393;180;340;520;1
10;72;empathy;994;320;220;540;1
10;74;reciprocity;1389;340;180;520;1
10;75;reciprocity;2325;380;40;420;0
10;76;reciprocity;781;360;160;520;1
10;77;reciprocity;934;60;380;440;1
10;78;reciprocity;2506;380;40;420;1
10;79;reciprocity;1152;340;180;520;1
10;80;reciprocity;1046;360;120;480;1
10;81;reciprocity;814;300;240;540;1
10;82;empathy;2029;380;20;400;0
10;83;empathy;815;280;280;560;1
10;84;empathy;1003;240;300;540;1
11;1;empathy;2347;240;300;540;1
11;2;empathy;2014;360;120;480;1
11;3;empathy;2979;380;20;400;1
11;4;empathy;2485;60;380;440;1
11;5;empathy;2539;160;360;520;1
11;6;empathy;2710;160;360;520;0
11;9;empathy;2704;360;120;480;0
11;11;reciprocity;1058;60;380;440;1
11;12;reciprocity;2031;380;60;440;1
11;13;empathy;2943;340;180;520;0
11;14;empathy;1567;380;40;420;1
11;15;empathy;1559;100;380;480;1
11;16;empathy;2193;380;100;480;1
11;17;empathy;1694;380;100;480;1
11;18;empathy;1253;380;60;440;1
11;19;reciprocity;1190;40;380;420;1
11;20;reciprocity;1140;180;340;520;1
11;22;reciprocity;1729;380;40;420;1
11;23;reciprocity;1664;120;360;480;1
11;24;reciprocity;2669;360;120;480;1
11;25;empathy;3149;100;380;480;1
11;26;empathy;2844;380;60;440;0
11;27;empathy;1365;40;380;420;1
11;28;empathy;1788;180;340;520;1
11;29;empathy;2316;220;320;540;0
11;30;empathy;2959;360;160;520;0
11;31;reciprocity;1527;340;180;520;1
11;32;reciprocity;1579;220;320;540;1
11;33;reciprocity;1902;300;240;540;1
11;34;empathy;1908;320;220;540;1
11;35;empathy;2118;300;240;540;1
11;36;empathy;2958;340;180;520;0
11;38;empathy;1629;120;360;480;1
11;39;empathy;2416;360;160;520;0
11;40;reciprocity;2977;160;360;520;1
11;41;reciprocity;1479;380;20;400;1
11;42;reciprocity;1887;380;20;400;1
11;43;reciprocity;1324;240;300;540;1
11;44;reciprocity;1696;180;340;520;1
11;45;reciprocity;1132;60;380;440;1
11;46;reciprocity;1666;340;180;520;1
11;47;reciprocity;1672;220;320;540;1
11;48;reciprocity;1884;380;40;420;1
11;49;reciprocity;1150;320;220;540;1
11;50;reciprocity;1030;120;360;480;1
11;51;reciprocity;1032;160;360;520;1
11;52;reciprocity;1311;240;300;540;1
11;53;reciprocity;1711;40;380;420;1
11;54;reciprocity;1518;380;60;440;1
11;55;reciprocity;2527;280;280;560;1
11;57;reciprocity;2324;300;240;540;1
11;58;reciprocity;1027;280;280;560;1
11;59;reciprocity;1010;360;160;520;1
11;61;empathy;1170;120;360;480;1
11;62;empathy;1560;280;280;560;1
11;63;empathy;1436;300;240;540;1
11;64;reciprocity;1845;380;100;480;1
11;65;reciprocity;1529;320;220;540;1
11;66;reciprocity;1760;100;380;480;1
11;67;empathy;1495;280;280;560;1
11;69;empathy;1048;220;320;540;1
11;70;empathy;2908;20;380;400;1
11;71;empathy;1043;60;380;440;1
11;73;reciprocity;1802;20;380;400;1
11;74;reciprocity;904;100;380;480;1
11;75;reciprocity;3003;360;160;520;0
11;76;empathy;1931;40;380;420;1
11;77;empathy;1140;20;380;400;1
11;78;empathy;3531;380;20;400;0
11;79;empathy;2903;380;40;420;0
11;80;empathy;1544;180;340;520;1
11;81;empathy;1973;320;220;540;1
11;82;reciprocity;1589;380;100;480;1
11;83;reciprocity;1970;360;120;480;0
11;84;reciprocity;1820;20;380;400;1
12;2;control;2075;380;40;420;0
12;3;control;2020;380;40;420;0
12;4;control;2550;20;380;400;0
12;5;control;2513;220;320;540;1
12;6;control;1673;180;340;520;1
12;7;control;1733;100;380;480;1
12;8;control;1874;380;60;440;0
12;9;control;1595;100;380;480;0
12;10;control;2607;380;20;400;1
12;11;control;2107;280;280;560;1
12;12;control;1411;40;380;420;1
12;14;multi-motive;1505;360;160;520;1
12;15;multi-motive;1206;380;20;400;0
12;16;control;1759;60;380;440;1
12;17;control;1609;160;360;520;0
12;18;control;2331;60;380;440;0
12;19;multi-motive;1839;300;240;540;0
12;20;multi-motive;2397;380;60;440;0
12;21;multi-motive;2501;300;240;540;0
12;22;control;1829;180;340;520;1
12;23;control;1499;220;320;540;1
12;24;control;1590;120;360;480;1
12;25;multi-motive;1924;220;320;540;1
12;26;multi-motive;1477;120;360;480;1
12;27;multi-motive;1422;240;300;540;0
12;28;multi-motive;1479;20;380;400;1
12;29;multi-motive;2336;40;380;420;1
12;30;multi-motive;2308;60;380;440;1
12;31;multi-motive;2424;360;120;480;0
12;32;multi-motive;1808;180;340;520;1
12;34;control;1466;380;20;400;0
12;35;control;1667;300;240;540;0
12;36;control;1701;340;180;520;0
12;37;multi-motive;1457;280;280;560;0
12;38;multi-motive;1524;380;100;480;0
12;39;multi-motive;2382;20;380;400;1
12;40;multi-motive;2485;120;360;480;1
12;41;multi-motive;2396;100;380;480;1
12;42;multi-motive;1671;40;380;420;1
12;43;multi-motive;1768;320;220;540;1
12;45;multi-motive;1816;240;300;540;1
12;46;multi-motive;1744;160;360;520;1
12;47;multi-motive;2432;360;160;520;0
12;48;multi-motive;1797;320;220;540;0
12;49;control;1344;380;100;480;0
12;50;control;1922;160;360;520;1
12;52;control;2693;40;380;420;0
12;53;control;2072;300;240;540;1
12;54;control;2189;360;160;520;0
12;57;control;1714;20;380;400;1
12;58;control;1763;120;360;480;0
12;59;control;1252;340;180;520;0
12;60;control;1731;360;120;480;0
12;61;multi-motive;2400;340;180;520;0
12;63;multi-motive;2342;380;100;480;1
12;64;control;1836;320;220;540;0
12;65;control;1098;360;160;520;0
12;66;control;1657;240;300;540;1
12;67;multi-motive;1916;380;40;420;0
12;68;multi-motive;2174;180;340;520;0
12;69;multi-motive;2295;340;180;520;0
12;70;control;2705;280;280;560;1
12;71;control;1619;380;100;480;0
12;72;control;2072;320;220;540;1
12;73;control;1253;360;120;480;0
12;74;control;1333;240;300;540;0
12;75;control;1563;380;60;440;0
12;76;multi-motive;1641;160;360;520;1
12;77;multi-motive;1310;60;380;440;1
12;78;multi-motive;2009;280;280;560;1
12;79;multi-motive;1165;380;40;420;0
12;80;multi-motive;2079;360;120;480;0
12;81;multi-motive;1751;380;20;400;0
12;82;multi-motive;1613;380;60;440;0
12;83;multi-motive;2127;220;320;540;0
12;84;multi-motive;1378;100;380;480;1
13;1;control;2757;100;380;480;1
13;2;control;1479;120;360;480;1
13;3;control;2762;360;160;520;0
13;4;multi-motive;1824;380;40;420;0
13;5;multi-motive;1752;340;180;520;1
13;6;multi-motive;1833;60;380;440;1
13;7;multi-motive;1585;220;320;540;1
13;8;multi-motive;3231;60;380;440;0
13;9;multi-motive;1474;300;240;540;0
13;10;multi-motive;1121;360;160;520;1
13;11;multi-motive;1950;360;120;480;0
13;12;multi-motive;1183;120;360;480;1
13;13;multi-motive;1062;40;380;420;1
13;14;multi-motive;2896;160;360;520;0
13;15;multi-motive;1492;340;180;520;0
13;16;multi-motive;2706;240;300;540;1
13;17;multi-motive;2065;300;240;540;1
13;18;multi-motive;1372;280;280;560;0
13;20;control;3535;380;20;400;1
13;21;control;2674;60;380;440;1
13;22;control;2681;380;60;440;1
13;23;control;1290;20;380;400;1
13;24;control;1538;40;380;420;1
13;26;control;2235;300;240;540;0
13;27;control;3324;380;100;480;1
13;28;multi-motive;2314;40;380;420;0
13;30;multi-motive;2395;380;100;480;1
13;31;multi-motive;1552;360;160;520;0
13;32;multi-motive;1713;20;380;400;1
13;33;multi-motive;3919;360;120;480;1
13;34;control;2242;220;320;540;0
13;35;control;1236;240;300;540;1
13;37;control;1236;220;320;540;1
13;38;control;1296;100;380;480;0
13;39;control;2950;380;40;420;0
13;40;control;2317;40;380;420;0
13;41;control;2548;320;220;540;1
13;42;control;2306;320;220;540;0
13;43;control;3048;300;240;540;1
13;44;control;2134;380;100;480;0
13;45;control;3108;240;300;540;0
13;46;control;3926;120;360;480;0
13;48;control;2875;160;360;520;1
13;49;multi-motive;2306;320;220;540;0
13;50;multi-motive;2471;180;340;520;1
13;51;multi-motive;2188;320;220;540;1
13;52;control;1967;340;180;520;0
13;53;control;2267;180;340;520;0
13;54;control;3611;20;380;400;1
13;56;multi-motive;3761;380;20;400;0
13;57;multi-motive;3348;280;280;560;1
13;59;control;2817;360;120;480;0
13;60;control;2986;280;280;560;0
13;61;control;2979;340;180;520;1
13;62;control;1895;360;160;520;1
13;63;control;2799;60;380;440;1
13;64;multi-motive;2751;180;340;520;0
13;65;multi-motive;3683;380;60;440;1
13;66;multi-motive;2761;380;100;480;1
13;67;multi-motive;2320;100;380;480;1
13;68;multi-motive;2566;380;60;440;0
13;69;multi-motive;2899;120;360;480;0
13;70;multi-motive;2099;160;360;520;1
13;71;multi-motive;3666;20;380;400;1
13;73;multi-motive;2305;240;300;540;1
13;74;multi-motive;2129;220;320;540;0
13;83;control;2410;280;280;560;1
13;84;control;1942;180;340;520;1
14;1;multi-motive;2261;100;380;480;1
14;2;multi-motive;2085;160;360;520;1
14;3;multi-motive;2925;380;60;440;1
14;4;control;2167;300;240;540;1
14;5;control;2511;380;40;420;1
14;6;control;2849;240;300;540;1
14;7;control;2828;20;380;400;1
14;8;control;1792;40;380;420;1
14;9;control;1823;180;340;520;1
14;10;control;2508;300;240;540;1
14;11;control;2528;360;160;520;1
14;12;control;1750;40;380;420;1
14;14;control;1473;100;380;480;1
14;15;control;940;280;280;560;1
14;16;control;1630;360;160;520;1
14;17;control;2880;20;380;400;1
14;19;control;2279;60;380;440;1
14;20;control;1870;380;100;480;1
14;21;control;3310;380;20;400;1
14;22;multi-motive;3718;380;20;400;1
14;23;multi-motive;2621;380;100;480;1
14;24;multi-motive;2014;100;380;480;1
14;26;multi-motive;1420;320;220;540;1
14;27;multi-motive;1691;360;120;480;1
14;28;control;1672;280;280;560;1
14;29;control;1828;60;380;440;1
14;30;control;1508;340;180;520;1
14;31;multi-motive;1682;20;380;400;1
14;33;multi-motive;3081;360;120;480;1
14;34;multi-motive;1980;360;160;520;1
14;35;multi-motive;1139;240;300;540;1
14;37;multi-motive;1108;160;360;520;1
14;38;multi-motive;1600;280;280;560;1
14;39;multi-motive;1442;340;180;520;1
14;40;control;1157;160;360;520;1
14;41;control;2188;220;320;540;1
14;42;control;1532;120;360;480;1
14;43;multi-motive;2461;320;220;540;1
14;44;multi-motive;2205;280;280;560;1
14;45;multi-motive;1361;380;40;420;1
14;46;control;1495;340;180;520;1
14;47;control;1031;380;60;440;1
14;49;multi-motive;1423;120;360;480;1
14;50;multi-motive;1732;380;40;420;1
14;51;multi-motive;1494;180;340;520;1
14;52;multi-motive;2063;300;240;540;1
14;53;multi-motive;1541;220;320;540;1
14;54;multi-motive;2064;40;380;420;1
14;55;multi-motive;2348;380;20;400;1
14;56;multi-motive;1227;380;100;480;1
14;57;multi-motive;1603;340;180;520;1
14;58;control;1973;360;120;480;1
14;59;control;1247;160;360;520;1
14;60;control;1861;380;100;480;1
14;61;control;1512;180;340;520;1
14;62;control;1419;100;380;480;1
14;63;control;1873;240;300;540;1
14;64;control;1518;320;220;540;1
14;65;control;1696;120;360;480;1
14;66;control;2373;380;20;400;1
14;67;multi-motive;2177;380;60;440;1
14;68;multi-motive;1241;20;380;400;1
14;69;multi-motive;1916;360;160;520;1
14;70;multi-motive;1131;180;340;520;1
14;71;multi-motive;1370;60;380;440;1
14;72;multi-motive;1246;40;380;420;1
14;73;multi-motive;946;300;240;540;1
14;75;multi-motive;1274;220;320;540;1
14;76;control;1227;320;220;540;1
14;77;control;1094;360;120;480;1
14;78;control;1660;380;60;440;1
14;79;multi-motive;1054;60;380;440;1
14;80;multi-motive;1731;120;360;480;1
14;81;multi-motive;1499;240;300;540;1
14;82;control;1399;220;320;540;1
14;83;control;2516;380;40;420;1
15;1;multi-motive;1786;40;380;420;1
15;2;multi-motive;1891;240;300;540;1
15;3;multi-motive;1634;300;240;540;1
15;4;control;1468;40;380;420;1
15;5;control;2069;380;100;480;1
15;6;control;3245;360;160;520;1
15;7;multi-motive;1547;380;100;480;1
15;8;multi-motive;2290;180;340;520;1
15;9;multi-motive;1888;180;340;520;1
15;10;control;1689;360;160;520;1
15;11;control;3665;380;20;400;1
15;12;control;2878;380;100;480;1
15;13;multi-motive;2939;360;120;480;1
15;14;multi-motive;1240;160;360;520;1
15;15;multi-motive;1219;120;360;480;1
15;16;multi-motive;1223;220;320;540;1
15;17;multi-motive;1615;360;120;480;1
15;18;multi-motive;1308;380;20;400;1
15;19;control;1349;300;240;540;1
15;20;control;1057;120;360;480;1
15;21;control;3375;380;20;400;1
15;22;multi-motive;1372;360;160;520;1
15;23;multi-motive;1903;100;380;480;1
15;24;multi-motive;1572;380;40;420;1
15;25;multi-motive;2605;280;280;560;1
15;27;multi-motive;1656;40;380;420;1
15;28;multi-motive;1994;380;60;440;1
15;29;multi-motive;1795;380;40;420;1
15;31;multi-motive;1656;340;180;520;1
15;32;multi-motive;1973;120;360;480;1
15;33;multi-motive;1842;20;380;400;1
15;34;control;2623;340;180;520;1
15;35;control;2717;360;120;480;0
15;37;multi-motive;2698;360;160;520;1
15;38;multi-motive;1939;280;280;560;1
15;39;multi-motive;2754;380;60;440;1
15;40;multi-motive;1726;160;360;520;1
15;41;multi-motive;1481;380;100;480;1
15;42;multi-motive;1363;320;220;540;1
15;43;control;2905;240;300;540;1
15;44;control;3211;160;360;520;1
15;46;control;2698;40;380;420;1
15;47;control;2197;220;320;540;1
15;48;control;1401;100;380;480;1
15;49;control;2038;100;380;480;1
15;51;control;1601;60;380;440;1
15;52;multi-motive;2506;380;20;400;1
15;53;multi-motive;1364;300;240;540;1
15;54;multi-motive;1174;320;220;540;1
15;55;control;2092;380;60;440;1
15;56;control;1381;220;320;540;1
15;57;control;3433;380;60;440;1
15;58;control;1270;20;380;400;1
15;59;control;1217;180;340;520;1
15;61;control;1362;300;240;540;1
15;62;control;1676;280;280;560;1
15;63;control;1929;360;120;480;1
15;64;control;1911;20;380;400;1
15;66;control;1547;280;280;560;1
15;67;control;1677;60;380;440;1
15;68;control;2155;380;40;420;1
15;69;control;3088;340;180;520;1
15;70;control;1439;320;220;540;1
15;71;control;1419;160;360;520;1
15;72;control;1473;240;300;540;1
15;73;multi-motive;1579;220;320;540;1
15;74;multi-motive;1713;60;380;440;1
15;75;multi-motive;1205;100;380;480;1
15;76;multi-motive;1118;60;380;440;1
15;77;multi-motive;1710;20;380;400;1
15;78;multi-motive;1521;340;180;520;1
15;79;control;1568;380;40;420;1
15;80;control;1350;320;220;540;1
15;81;control;1405;180;340;520;1
15;82;multi-motive;1396;240;300;540;1
16;1;control;1847;180;340;520;1
16;2;control;2276;380;40;420;0
16;3;control;2518;380;100;480;1
16;4;multi-motive;1381;40;380;420;1
16;5;multi-motive;1907;220;320;540;1
16;7;multi-motive;933;240;300;540;1
16;8;multi-motive;1270;240;300;540;1
16;9;multi-motive;1970;120;360;480;0
16;10;control;1485;320;220;540;1
16;11;control;1765;380;60;440;1
16;12;control;1254;60;380;440;1
16;13;multi-motive;1397;180;340;520;1
16;15;multi-motive;1690;380;100;480;0
16;16;control;1489;280;280;560;1
16;17;control;1330;320;220;540;1
16;18;control;1468;220;320;540;0
16;19;control;2111;360;160;520;1
16;20;control;1548;340;180;520;1
16;21;control;1287;340;180;520;1
16;22;multi-motive;2080;280;280;560;1
16;23;multi-motive;1676;220;320;540;1
16;24;multi-motive;1622;360;160;520;1
16;25;control;2381;360;120;480;0
16;26;control;1220;100;380;480;1
16;27;control;1619;280;280;560;1
16;28;control;1648;180;340;520;1
16;29;control;946;240;300;540;1
16;30;control;1708;40;380;420;1
16;32;control;1024;40;380;420;1
16;33;control;1735;20;380;400;1
16;34;multi-motive;1587;120;360;480;1
16;35;multi-motive;1780;380;100;480;0
16;36;multi-motive;2556;340;180;520;1
16;37;multi-motive;2149;340;180;520;0
16;38;multi-motive;904;280;280;560;1
16;39;multi-motive;2018;360;120;480;1
16;40;multi-motive;1645;160;360;520;1
16;42;multi-motive;902;20;380;400;1
16;43;multi-motive;1018;60;380;440;1
16;44;multi-motive;1665;40;380;420;1
16;45;multi-motive;1963;380;20;400;0
16;46;multi-motive;2238;300;240;540;1
16;47;multi-motive;1902;380;60;440;1
16;48;multi-motive;1982;380;60;440;0
16;49;multi-motive;1599;320;220;540;1
16;50;multi-motive;1607;180;340;520;1
16;51;multi-motive;1302;60;380;440;1
16;52;control;2189;380;100;480;1
16;54;control;1884;160;360;520;1
16;56;multi-motive;1368;380;40;420;0
16;57;multi-motive;1386;20;380;400;1
16;58;multi-motive;2130;380;20;400;0
16;59;multi-motive;1131;360;160;520;1
16;61;control;1412;380;20;400;1
16;62;control;1368;120;360;480;1
16;63;control;927;360;160;520;1
16;64;control;1155;380;20;400;0
16;65;control;1802;100;380;480;1
16;66;control;1919;380;60;440;0
16;68;control;1654;160;360;520;1
16;69;control;1797;380;40;420;1
16;71;control;1471;360;120;480;1
16;72;control;1180;300;240;540;1
16;73;control;913;120;360;480;1
16;74;control;2179;60;380;440;1
16;75;control;1833;240;300;540;1
16;76;control;1514;220;320;540;1
16;77;control;1296;20;380;400;1
16;78;control;1124;300;240;540;1
16;79;multi-motive;1073;160;360;520;1
16;80;multi-motive;1732;380;40;420;1
16;81;multi-motive;1428;320;220;540;1
16;82;multi-motive;1295;100;380;480;1
16;83;multi-motive;997;300;240;540;1
16;84;multi-motive;825;100;380;480;1
17;1;empathy;2602;380;60;440;1
17;2;empathy;3673;300;240;540;0
17;3;empathy;3124;360;160;520;1
17;4;reciprocity;1915;20;380;400;1
17;5;reciprocity;1645;40;380;420;1
17;6;reciprocity;1661;280;280;560;1
17;7;empathy;2029;340;180;520;1
17;8;empathy;1871;380;40;420;1
17;9;empathy;3107;20;380;400;0
17;10;reciprocity;1910;380;40;420;1
17;11;reciprocity;1214;20;380;400;1
17;12;reciprocity;1629;360;120;480;1
17;13;empathy;2471;320;220;540;1
17;14;empathy;2829;240;300;540;1
17;15;empathy;1443;20;380;400;1
17;17;reciprocity;1615;360;160;520;1
17;18;reciprocity;1510;380;100;480;1
17;19;reciprocity;2452;300;240;540;1
17;20;reciprocity;1285;60;380;440;1
17;21;reciprocity;1628;340;180;520;1
17;22;reciprocity;1661;360;160;520;1
17;23;reciprocity;1842;240;300;540;1
17;24;reciprocity;1472;180;340;520;1
17;25;reciprocity;1785;380;100;480;1
17;26;reciprocity;1571;320;220;540;1
17;27;reciprocity;2100;380;20;400;1
17;28;empathy;2009;360;120;480;1
17;29;empathy;1853;100;380;480;1
17;30;empathy;3595;380;100;480;1
17;31;empathy;1926;380;60;440;1
17;33;empathy;1657;320;220;540;1
17;35;reciprocity;2337;120;360;480;1
17;36;reciprocity;1534;100;380;480;1
17;37;reciprocity;1766;40;380;420;1
17;38;reciprocity;2233;240;300;540;1
17;39;reciprocity;2141;180;340;520;1
17;40;empathy;1638;40;380;420;1
17;41;empathy;1887;380;20;400;1
17;42;empathy;2789;180;340;520;1
17;43;empathy;2802;360;120;480;0
17;44;empathy;2500;40;380;420;1
17;46;empathy;1680;120;360;480;1
17;47;empathy;2609;60;380;440;1
17;48;empathy;1565;160;360;520;1
17;49;empathy;2677;380;20;400;0
17;50;empathy;1752;300;240;540;1
17;52;reciprocity;2645;220;320;540;1
17;54;reciprocity;2555;60;380;440;1
17;55;reciprocity;3880;380;60;440;1
17;56;reciprocity;2380;280;280;560;1
17;57;reciprocity;2934;320;220;540;1
17;58;empathy;3106;380;40;420;0
17;59;empathy;2273;180;340;520;1
17;60;empathy;3159;220;320;540;0
17;61;reciprocity;2416;340;180;520;1
17;62;reciprocity;1750;300;240;540;1
17;64;empathy;1981;280;280;560;1
17;65;empathy;2578;280;280;560;0
17;66;empathy;1798;220;320;540;1
17;67;empathy;1852;60;380;440;1
17;68;empathy;2769;340;180;520;0
17;70;reciprocity;1813;380;60;440;1
17;71;reciprocity;2043;360;120;480;1
17;72;reciprocity;1364;120;360;480;1
17;73;empathy;3013;100;380;480;0
17;74;empathy;1469;240;300;540;1
17;75;empathy;1626;360;160;520;1
17;76;empathy;2620;120;360;480;0
17;77;empathy;1652;380;100;480;1
17;78;empathy;2744;160;360;520;0
17;79;reciprocity;2025;220;320;540;1
17;80;reciprocity;2103;160;360;520;1
17;81;reciprocity;1604;380;20;400;1
17;82;reciprocity;1685;160;360;520;1
17;83;reciprocity;2106;100;380;480;1
17;84;reciprocity;3064;380;40;420;0
18;1;empathy;978;40;380;420;1
18;2;empathy;1660;20;380;400;1
18;3;empathy;1233;60;380;440;1
18;4;empathy;1208;360;160;520;1
18;5;empathy;1168;380;40;420;0
18;6;empathy;1790;380;60;440;0
18;7;reciprocity;1049;120;360;480;1
18;9;reciprocity;906;220;320;540;1
18;11;empathy;1416;220;320;540;1
18;13;reciprocity;1077;380;60;440;0
18;15;reciprocity;1074;20;380;400;1
18;16;empathy;1424;360;120;480;0
18;17;empathy;1403;380;60;440;0
18;18;empathy;904;20;380;400;1
18;19;reciprocity;683;300;240;540;1
18;20;reciprocity;1051;380;20;400;0
18;21;reciprocity;1188;340;180;520;1
18;22;empathy;655;120;360;480;1
18;23;empathy;1354;160;360;520;1
18;24;empathy;798;100;380;480;1
18;26;reciprocity;631;160;360;520;1
18;27;reciprocity;610;100;380;480;1
18;29;reciprocity;1014;360;120;480;0
18;30;reciprocity;1205;320;220;540;1
18;31;empathy;1801;240;300;540;1
18;32;empathy;1300;60;380;440;1
18;33;empathy;1185;120;360;480;1
18;34;empathy;978;100;380;480;1
18;35;empathy;1320;300;240;540;1
18;36;empathy;945;360;160;520;0
18;37;empathy;1508;340;180;520;1
18;38;empathy;1467;380;100;480;0
18;39;empathy;990;160;360;520;1
18;40;empathy;1143;360;120;480;1
18;41;empathy;975;380;20;400;0
18;42;empathy;1577;180;340;520;0
18;43;reciprocity;1558;380;100;480;0
18;44;reciprocity;748;100;380;480;1
18;45;reciprocity;1127;220;320;540;1
18;46;reciprocity;1655;280;280;560;0
18;47;reciprocity;896;60;380;440;1
18;48;reciprocity;1171;120;360;480;1
18;49;reciprocity;698;60;380;440;1
18;50;reciprocity;638;160;360;520;1
18;51;reciprocity;577;180;340;520;1
18;52;empathy;1041;280;280;560;1
18;54;empathy;1016;340;180;520;1
18;55;reciprocity;1523;360;120;480;0
18;56;reciprocity;1019;360;160;520;0
18;57;reciprocity;712;380;20;400;0
18;58;reciprocity;1070;300;240;540;0
18;59;reciprocity;702;20;380;400;1
18;60;reciprocity;795;360;160;520;1
18;61;empathy;970;380;40;420;0
18;62;empathy;1086;40;380;420;1
18;63;empathy;979;380;20;400;0
18;64;reciprocity;1028;380;40;420;0
18;65;reciprocity;1295;240;300;540;1
18;66;reciprocity;1566;380;100;480;0
18;67;empathy;1200;280;280;560;0
18;69;empathy;764;180;340;520;1
18;70;reciprocity;1394;340;180;520;0
18;71;reciprocity;664;240;300;540;1
18;72;reciprocity;1220;320;220;540;0
18;73;reciprocity;543;40;380;420;1
18;74;reciprocity;920;280;280;560;1
18;75;reciprocity;797;180;340;520;1
18;76;reciprocity;972;380;60;440;0
18;77;reciprocity;1487;40;380;420;1
18;78;reciprocity;975;380;40;420;0
18;79;empathy;1255;320;220;540;0
18;80;empathy;1466;300;240;540;1
18;81;empathy;1487;380;100;480;0
18;82;empathy;989;320;220;540;0
18;83;empathy;1547;220;320;540;1
18;84;empathy;1100;240;300;540;1
19;1;reciprocity;3287;380;100;480;1
19;2;reciprocity;1165;160;360;520;1
19;3;reciprocity;1810;360;120;480;1
19;4;reciprocity;770;380;60;440;1
19;5;reciprocity;773;180;340;520;0
19;6;reciprocity;1481;120;360;480;1
19;7;reciprocity;1434;380;20;400;1
19;8;reciprocity;1852;380;40;420;0
19;9;reciprocity;2566;340;180;520;0
19;11;reciprocity;2965;220;320;540;1
19;12;reciprocity;1557;240;300;540;1
19;13;empathy;3793;380;60;440;0
19;15;empathy;2120;40;380;420;0
19;16;empathy;2219;300;240;540;1
19;17;empathy;2605;280;280;560;1
19;18;empathy;2419;360;120;480;0
19;19;empathy;2546;320;220;540;1
19;20;empathy;3434;340;180;520;1
19;22;empathy;2520;100;380;480;1
19;23;empathy;3479;380;40;420;0
19;24;empathy;3040;100;380;480;1
19;25;empathy;1136;40;380;420;1
19;28;reciprocity;1875;40;380;420;1
19;29;reciprocity;1684;340;180;520;1
19;31;reciprocity;1897;360;120;480;1
19;32;reciprocity;2813;380;100;480;0
19;33;reciprocity;1383;100;380;480;1
19;34;empathy;2579;120;360;480;1
19;35;empathy;2628;380;20;400;1
19;36;empathy;2630;160;360;520;1
19;37;empathy;1738;380;40;420;1
19;38;empathy;2808;20;380;400;1
19;39;empathy;2024;380;20;400;0
19;40;empathy;1350;240;300;540;1
19;41;empathy;1437;320;220;540;1
19;42;empathy;1089;380;60;440;0
19;43;empathy;2146;380;100;480;1
19;44;empathy;1677;60;380;440;0
19;46;empathy;1449;220;320;540;1
19;47;empathy;2482;60;380;440;1
19;48;empathy;2607;240;300;540;1
19;49;empathy;1169;340;180;520;1
19;50;empathy;2241;360;160;520;1
19;51;empathy;1735;360;120;480;1
19;52;reciprocity;1090;280;280;560;1
19;53;reciprocity;901;20;380;400;1
19;54;reciprocity;1100;120;360;480;1
19;55;empathy;1144;180;340;520;1
19;56;empathy;966;160;360;520;1
19;57;empathy;963;280;280;560;1
19;58;reciprocity;881;380;60;440;0
19;59;reciprocity;1662;380;20;400;1
19;60;reciprocity;3186;380;40;420;0
19;61;reciprocity;1989;240;300;540;1
19;62;reciprocity;1014;320;220;540;0
19;63;reciprocity;1243;280;280;560;1
19;66;reciprocity;3696;300;240;540;0
19;67;reciprocity;844;20;380;400;1
19;68;reciprocity;795;360;160;520;0
19;69;reciprocity;1106;40;380;420;1
19;70;empathy;980;380;100;480;1
19;71;empathy;907;300;240;540;1
19;72;empathy;893;120;360;480;1
19;73;reciprocity;2165;300;240;540;1
19;74;reciprocity;1752;220;320;540;1
19;75;reciprocity;849;180;340;520;1
19;76;reciprocity;903;60;380;440;1
19;77;reciprocity;656;100;380;480;1
19;78;reciprocity;1417;160;360;520;1
19;79;empathy;700;20;380;400;1
19;80;empathy;974;360;160;520;1
19;81;empathy;2377;180;340;520;1
19;82;reciprocity;1150;60;380;440;1
19;83;reciprocity;1328;360;160;520;1
19;84;reciprocity;1950;320;220;540;1
20;1;control;1930;120;360;480;1
20;2;control;1408;380;60;440;0
20;3;control;1181;60;380;440;1
20;4;control;2478;320;220;540;1
20;5;control;2336;60;380;440;1
20;6;control;2004;300;240;540;1
20;7;multi-motive;2746;380;40;420;1
20;8;multi-motive;2713;380;60;440;0
20;10;control;2749;380;100;480;0
20;11;control;1927;360;160;520;1
20;13;control;3568;320;220;540;1
20;15;control;1447;280;280;560;1
20;17;control;2424;280;280;560;0
20;18;control;2657;20;380;400;1
20;19;control;3036;40;380;420;0
20;21;control;1796;380;100;480;1
20;22;control;1303;360;120;480;0
20;23;control;2042;180;340;520;1
20;24;control;1704;360;160;520;0
20;25;control;2976;360;120;480;1
20;26;control;2634;240;300;540;0
20;27;control;1282;380;60;440;0
20;28;multi-motive;3029;280;280;560;1
20;30;multi-motive;1753;360;120;480;1
20;31;multi-motive;2840;380;20;400;0
20;33;multi-motive;2583;360;120;480;0
20;34;control;2015;160;360;520;1
20;35;control;1677;340;180;520;0
20;37;multi-motive;2109;340;180;520;0
20;38;multi-motive;2379;240;300;540;0
20;39;multi-motive;2099;380;40;420;0
20;40;control;1106;40;380;420;1
20;41;control;2386;340;180;520;1
20;42;control;2553;380;40;420;0
20;43;multi-motive;2376;280;280;560;1
20;44;multi-motive;2746;160;360;520;1
20;46;multi-motive;1535;380;100;480;0
20;47;multi-motive;1863;360;160;520;1
20;49;multi-motive;1171;20;380;400;1
20;50;multi-motive;1434;100;380;480;1
20;51;multi-motive;3140;160;360;520;0
20;52;multi-motive;1946;300;240;540;1
20;53;multi-motive;2314;60;380;440;1
20;57;control;973;20;380;400;1
20;58;multi-motive;1836;60;380;440;1
20;59;multi-motive;2061;120;360;480;1
20;60;multi-motive;1657;240;300;540;1
20;61;multi-motive;2812;320;220;540;0
20;62;multi-motive;1307;380;60;440;0
20;63;multi-motive;3590;340;180;520;0
20;64;control;1387;160;360;520;1
20;65;control;1823;380;40;420;0
20;66;control;3728;300;240;540;0
20;67;multi-motive;2106;180;340;520;1
20;68;multi-motive;2643;120;360;480;1
20;69;multi-motive;642;220;320;540;0
20;70;multi-motive;1236;180;340;520;1
20;71;multi-motive;1042;40;380;420;1
20;72;multi-motive;2568;40;380;420;1
20;73;control;2143;180;340;520;1
20;74;control;3257;120;360;480;1
20;75;control;2648;380;20;400;0
20;76;multi-motive;2327;360;160;520;0
20;77;multi-motive;2157;20;380;400;1
20;78;multi-motive;1331;380;20;400;0
20;79;multi-motive;1830;100;380;480;1
20;80;multi-motive;2965;300;240;540;0
20;82;control;3344;100;380;480;1
20;83;control;2722;380;20;400;0
20;84;control;2369;100;380;480;1
21;1;control;3799;300;240;540;0
21;2;control;2487;40;380;420;0
21;3;control;2065;180;340;520;0
21;4;multi-motive;2803;340;180;520;0
21;5;multi-motive;2367;380;60;440;1
21;6;multi-motive;2735;280;280;560;0
21;7;control;3260;380;20;400;1
21;8;control;2530;120;360;480;0
21;9;control;1928;320;220;540;1
21;10;multi-motive;1372;300;240;540;1
21;11;multi-motive;1102;280;280;560;1
21;12;multi-motive;1714;60;380;440;0
21;13;multi-motive;3005;300;240;540;0
21;14;multi-motive;1233;180;340;520;1
21;15;multi-motive;2909;40;380;420;0
21;16;control;2470;360;160;520;1
21;17;control;3560;20;380;400;0
21;18;control;1394;120;360;480;1
21;19;control;1802;160;360;520;0
21;20;control;1999;360;120;480;1
21;21;control;2533;360;160;520;1
21;22;control;1767;340;180;520;1
21;23;control;3532;240;300;540;0
21;25;multi-motive;3797;160;360;520;0
21;26;multi-motive;3983;360;160;520;1
21;27;multi-motive;1440;60;380;440;1
21;28;multi-motive;1611;160;360;520;1
21;29;multi-motive;2810;220;320;540;0
21;30;multi-motive;2179;340;180;520;1
21;31;multi-motive;1978;180;340;520;0
21;33;multi-motive;1337;360;120;480;1
21;34;multi-motive;2416;380;20;400;0
21;35;multi-motive;1400;360;160;520;0
21;36;multi-motive;2010;380;40;420;1
21;37;multi-motive;2150;100;380;480;1
21;38;multi-motive;1317;120;360;480;1
21;40;control;2854;380;100;480;0
21;41;control;1585;240;300;540;1
21;42;control;1584;160;360;520;1
21;43;control;1938;380;20;400;0
21;47;multi-motive;1612;240;300;540;1
21;48;multi-motive;1009;20;380;400;1
21;49;control;1933;380;60;440;0
21;51;control;3816;380;40;420;0
21;52;control;1449;20;380;400;1
21;53;control;3849;100;380;480;0
21;54;control;3491;320;220;540;0
21;55;control;2348;220;320;540;1
21;56;control;2201;300;240;540;0
21;58;multi-motive;2974;380;20;400;1
21;59;multi-motive;2987;20;380;400;0
21;60;multi-motive;1582;380;100;480;0
21;61;multi-motive;1991;220;320;540;1
21;62;multi-motive;2172;380;40;420;0
21;63;multi-motive;2530;380;60;440;1
21;64;multi-motive;3430;240;300;540;0
21;65;multi-motive;1358;320;220;540;0
21;66;multi-motive;3265;320;220;540;1
21;67;multi-motive;2826;380;100;480;1
21;68;multi-motive;1800;40;380;420;1
21;69;multi-motive;1473;100;380;480;0
21;70;control;2502;280;280;560;1
21;71;control;3102;380;40;420;1
21;72;control;3118;60;380;440;1
21;73;control;2795;60;380;440;1
21;74;control;2384;360;120;480;0
21;75;control;1801;100;380;480;1
21;76;control;2191;280;280;560;0
21;77;control;1418;180;340;520;1
21;78;control;1473;40;380;420;1
21;79;control;2314;380;100;480;1
21;81;control;2483;340;180;520;0
21;83;multi-motive;2291;120;360;480;0
22;1;control;2633;360;160;520;1
22;2;control;3108;220;320;540;1
22;3;control;1561;280;280;560;1
22;4;control;1619;180;340;520;1
22;5;control;1236;120;360;480;1
22;6;control;2733;380;20;400;0
22;7;control;1908;180;340;520;1
22;8;control;1591;100;380;480;1
22;9;control;2025;380;40;420;0
22;10;control;2074;160;360;520;1
22;11;control;1601;40;380;420;1
22;12;control;1494;40;380;420;1
22;13;multi-motive;1475;120;360;480;1
22;14;multi-motive;2272;380;20;400;0
22;15;multi-motive;1888;60;380;440;1
22;16;multi-motive;1419;240;300;540;1
22;17;multi-motive;1529;120;360;480;1
22;18;multi-motive;2829;360;160;520;0
22;19;multi-motive;1357;220;320;540;1
22;20;multi-motive;1360;40;380;420;1
22;21;multi-motive;1672;160;360;520;1
22;22;multi-motive;1948;380;40;420;0
22;23;multi-motive;1636;280;280;560;1
22;24;multi-motive;1573;380;100;480;1
22;25;control;2112;60;380;440;1
22;27;control;1355;100;380;480;1
22;28;control;2252;380;40;420;1
22;29;control;1593;240;300;540;1
22;30;control;3061;320;220;540;0
22;31;control;1721;160;360;520;1
22;32;control;1493;20;380;400;1
22;33;control;1855;340;180;520;1
22;34;control;2623;380;60;440;1
22;35;control;2726;380;60;440;0
22;37;multi-motive;1716;280;280;560;1
22;38;multi-motive;2333;380;60;440;0
22;39;multi-motive;1647;220;320;540;1
22;40;control;1981;360;120;480;1
22;41;control;2079;380;20;400;0
22;42;control;1811;300;240;540;1
22;43;multi-motive;2346;380;60;440;1
22;44;multi-motive;1629;240;300;540;1
22;45;multi-motive;1525;20;380;400;1
22;46;multi-motive;2371;380;100;480;1
22;48;multi-motive;2577;320;220;540;1
22;49;multi-motive;1814;160;360;520;1
22;50;multi-motive;1314;180;340;520;1
22;51;multi-motive;2555;360;120;480;1
22;52;multi-motive;1623;300;240;540;1
22;53;multi-motive;2082;360;160;520;0
22;54;multi-motive;1216;100;380;480;1
22;55;multi-motive;1921;380;40;420;1
22;56;multi-motive;1294;180;340;520;1
22;57;multi-motive;1333;40;380;420;1
22;59;control;1610;340;180;520;1
22;61;multi-motive;1355;320;220;540;1
22;62;multi-motive;1602;20;380;400;1
22;63;multi-motive;1303;300;240;540;1
22;64;multi-motive;2304;360;120;480;1
22;67;control;1070;60;380;440;1
22;68;control;1222;20;380;400;1
22;69;control;1509;120;360;480;1
22;70;multi-motive;1494;100;380;480;1
22;71;multi-motive;2203;380;20;400;0
22;72;multi-motive;1481;340;180;520;1
22;73;control;1483;240;300;540;1
22;74;control;1077;220;320;540;1
22;75;control;1629;360;120;480;1
22;76;control;1411;320;220;540;1
22;77;control;1441;380;100;480;1
22;78;control;1519;380;100;480;0
22;79;multi-motive;977;60;380;440;1
22;81;multi-motive;1988;340;180;520;0
22;83;control;1672;300;240;540;1
22;84;control;1224;280;280;560;1
23;1;reciprocity;2460;380;20;400;0
23;2;reciprocity;2213;20;380;400;1
23;3;reciprocity;2311;380;20;400;1
23;4;reciprocity;3925;360;120;480;0
23;5;reciprocity;3497;380;100;480;1
23;6;reciprocity;3100;300;240;540;0
23;8;empathy;3233;380;40;420;1
23;9;empathy;1567;100;380;480;1
23;10;empathy;1861;120;360;480;1
23;11;empathy;2332;360;160;520;1
23;12;empathy;2236;380;60;440;1
23;13;empathy;1390;280;280;560;1
23;14;empathy;2805;300;240;540;1
23;15;empathy;1540;240;300;540;1
23;16;reciprocity;3796;360;160;520;1
23;17;reciprocity;3157;280;280;560;0
23;18;reciprocity;2825;160;360;520;1
23;19;empathy;2883;160;360;520;1
23;20;empathy;2756;380;100;480;1
23;21;empathy;2173;40;380;420;1
23;22;reciprocity;1982;360;120;480;1
23;23;reciprocity;2197;120;360;480;1
23;24;reciprocity;2348;220;320;540;1
23;25;reciprocity;1872;380;60;440;1
23;26;reciprocity;1937;320;220;540;1
23;27;reciprocity;2470;60;380;440;1
23;28;empathy;2124;20;380;400;1
23;29;empathy;2062;380;20;400;1
23;31;reciprocity;1943;160;360;520;1
23;32;reciprocity;1995;280;280;560;1
23;33;reciprocity;2408;60;380;440;1
23;34;empathy;2781;320;220;540;1
23;36;empathy;2228;240;300;540;1
23;38;reciprocity;1943;180;340;520;1
23;39;reciprocity;2671;300;240;540;1
23;40;reciprocity;2542;380;60;440;1
23;41;reciprocity;1809;380;40;420;0
23;42;reciprocity;2347;240;300;540;1
23;43;reciprocity;1292;40;380;420;1
23;44;reciprocity;1496;100;380;480;1
23;46;reciprocity;2283;340;180;520;1
23;47;reciprocity;3825;360;160;520;1
23;48;reciprocity;2288;320;220;540;1
23;49;reciprocity;2020;100;380;480;1
23;50;reciprocity;2232;180;340;520;1
23;51;reciprocity;3018;120;360;480;1
23;53;empathy;3229;60;380;440;1
23;54;empathy;1574;320;220;540;1
23;55;empathy;3041;100;380;480;1
23;56;empathy;2226;180;340;520;1
23;57;empathy;2084;360;120;480;1
23;58;empathy;2157;220;320;540;1
23;60;empathy;1587;60;380;440;1
23;62;reciprocity;1851;380;100;480;1
23;63;reciprocity;2216;240;300;540;1
23;64;empathy;2631;380;20;400;1
23;65;empathy;2210;220;320;540;1
23;66;empathy;2185;40;380;420;1
23;68;reciprocity;3160;220;320;540;1
23;69;reciprocity;1645;40;380;420;1
23;71;reciprocity;1874;340;180;520;1
23;72;reciprocity;1514;20;380;400;1
23;73;empathy;2351;120;360;480;1
23;74;empathy;3128;180;340;520;1
23;75;empathy;3319;380;40;420;0
23;76;empathy;2987;280;280;560;1
23;78;empathy;1555;20;380;400;1
23;79;empathy;1738;360;160;520;1
23;80;empathy;2269;380;100;480;1
23;82;empathy;2796;340;180;520;1
23;83;empathy;1672;300;240;540;1
23;84;empathy;2987;160;360;520;1
24;1;empathy;1373;320;220;540;1
24;2;empathy;1249;100;380;480;1
24;4;empathy;1009;160;360;520;1
24;5;empathy;889;300;240;540;0
24;6;empathy;902;220;320;540;1
24;7;reciprocity;899;300;240;540;1
24;8;reciprocity;1031;360;120;480;1
24;9;reciprocity;1287;340;180;520;0
24;10;reciprocity;1224;280;280;560;1
24;11;reciprocity;1841;60;380;440;0
24;12;reciprocity;1151;20;380;400;1
24;13;reciprocity;1505;180;340;520;1
24;14;reciprocity;856;160;360;520;1
24;15;reciprocity;1193;340;180;520;1
24;16;reciprocity;1199;100;380;480;0
24;17;reciprocity;1392;380;100;480;1
24;18;reciprocity;886;380;60;440;1
24;19;reciprocity;1186;360;160;520;1
24;20;reciprocity;1110;240;300;540;1
24;21;reciprocity;972;60;380;440;1
24;22;empathy;781;20;380;400;1
24;23;empathy;780;280;280;560;1
24;24;empathy;977;60;380;440;1
24;25;reciprocity;742;220;320;540;1
24;26;reciprocity;1081;40;380;420;1
24;27;reciprocity;1674;380;20;400;0
24;28;empathy;1783;380;100;480;1
24;30;empathy;1141;340;180;520;1
24;31;empathy;1006;180;340;520;1
24;32;empathy;780;320;220;540;1
24;33;empathy;934;40;380;420;1
24;34;empathy;1176;100;380;480;1
24;35;empathy;867;380;40;420;1
24;36;empathy;1723;180;340;520;0
24;37;empathy;1149;340;180;520;1
24;40;reciprocity;1186;300;240;540;1
24;41;reciprocity;816;120;360;480;1
24;42;reciprocity;1564;220;320;540;0
24;43;empathy;1891;220;320;540;1
24;44;empathy;1347;380;40;420;1
24;45;empathy;1015;360;120;480;1
24;46;empathy;1255;240;300;540;1
24;47;empathy;1207;380;20;400;1
24;48;empathy;1722;20;380;400;1
24;49;empathy;756;240;300;540;1
24;50;empathy;1809;380;60;440;0
24;51;empathy;776;380;20;400;1
24;53;reciprocity;1670;380;100;480;0
24;54;reciprocity;1722;320;220;540;1
24;55;reciprocity;1709;380;60;440;1
24;56;reciprocity;1015;160;360;520;1
24;57;reciprocity;1058;360;120;480;1
24;58;empathy;1129;380;100;480;1
24;59;empathy;1695;300;240;540;1
24;60;empathy;1482;60;380;440;1
24;61;reciprocity;2273;360;160;520;0
24;62;reciprocity;1339;120;360;480;1
24;63;reciprocity;1087;380;40;420;1
24;64;reciprocity;831;100;380;480;1
24;65;reciprocity;1259;380;40;420;1
24;69;reciprocity;1034;180;340;520;1
24;70;reciprocity;1907;380;20;400;1
24;71;reciprocity;874;280;280;560;1
24;72;reciprocity;1111;240;300;540;0
24;73;empathy;796;360;160;520;1
24;74;empathy;1757;280;280;560;1
24;75;empathy;941;160;360;520;1
24;76;reciprocity;1235;320;220;540;0
24;77;reciprocity;1392;40;380;420;1
24;78;reciprocity;1368;20;380;400;1
24;79;empathy;1137;360;120;480;1
24;80;empathy;1092;360;160;520;1
24;81;empathy;1375;120;360;480;1
24;82;empathy;1088;380;60;440;1
24;83;empathy;552;120;360;480;1
24;84;empathy;1072;40;380;420;1
25;1;reciprocity;2119;360;120;480;1
25;2;reciprocity;1978;180;340;520;1
25;3;reciprocity;1974;340;180;520;0
25;4;empathy;1711;240;300;540;1
25;5;empathy;2593;300;240;540;1
25;6;empathy;1682;240;300;540;1
25;7;reciprocity;1612;380;60;440;1
25;8;reciprocity;1359;220;320;540;1
25;9;reciprocity;1935;320;220;540;0
25;10;empathy;3575;320;220;540;1
25;11;empathy;1332;160;360;520;1
25;12;empathy;1703;180;340;520;1
25;14;empathy;1646;60;380;440;1
25;15;empathy;1102;40;380;420;1
25;17;empathy;2314;360;120;480;1
25;18;empathy;1485;160;360;520;1
25;19;empathy;891;100;380;480;1
25;20;empathy;1284;120;360;480;1
25;21;empathy;2741;380;60;440;1
25;22;empathy;2399;380;40;420;0
25;23;empathy;1828;360;120;480;1
25;24;empathy;2878;380;20;400;1
25;25;reciprocity;2891;380;40;420;1
25;26;reciprocity;1895;320;220;540;1
25;27;reciprocity;1480;180;340;520;1
25;28;reciprocity;1270;160;360;520;1
25;29;reciprocity;1975;240;300;540;0
25;30;reciprocity;2243;220;320;540;1
25;31;reciprocity;2898;380;100;480;1
25;32;reciprocity;1071;20;380;400;1
25;33;reciprocity;2180;380;60;440;0
25;34;empathy;2362;280;280;560;1
25;35;empathy;1190;220;320;540;1
25;36;empathy;1497;360;160;520;1
25;37;empathy;945;180;340;520;1
25;38;empathy;1845;380;20;400;0
25;40;empathy;740;20;380;400;1
25;41;empathy;1397;280;280;560;1
25;43;empathy;1137;20;380;400;1
25;44;empathy;1165;120;360;480;1
25;45;empathy;990;60;380;440;1
25;46;reciprocity;2540;160;360;520;1
25;47;reciprocity;2066;100;380;480;1
25;48;reciprocity;1497;280;280;560;1
25;50;reciprocity;996;40;380;420;1
25;51;reciprocity;2220;380;100;480;0
25;52;empathy;1432;340;180;520;1
25;53;empathy;2363;40;380;420;1
25;54;empathy;2280;360;160;520;1
25;56;reciprocity;2093;60;380;440;1
25;57;reciprocity;1758;280;280;560;1
25;58;empathy;2452;380;100;480;1
25;59;empathy;2533;380;40;420;1
25;60;empathy;3096;300;240;540;0
25;61;empathy;2253;380;100;480;1
25;62;empathy;1945;100;380;480;1
25;63;empathy;936;320;220;540;1
25;64;reciprocity;2417;300;240;540;1
25;66;reciprocity;179;120;360;480;1
25;67;empathy;1927;340;180;520;1
25;69;empathy;2754;380;60;440;1
25;70;reciprocity;2290;360;160;520;1
25;71;reciprocity;3507;380;40;420;0
25;72;reciprocity;1274;60;380;440;1
25;73;reciprocity;1293;340;180;520;1
25;74;reciprocity;2531;360;160;520;1
25;75;reciprocity;1270;300;240;540;1
25;77;reciprocity;2758;380;20;400;0
25;78;reciprocity;1971;360;120;480;1
25;79;reciprocity;2201;380;20;400;0
25;80;reciprocity;3037;40;380;420;1
25;81;reciprocity;1144;100;380;480;1
25;82;reciprocity;1196;120;360;480;1
25;83;reciprocity;1909;240;300;540;1
25;84;reciprocity;2583;20;380;400;1
26;2;reciprocity;2904;180;340;520;1
26;3;reciprocity;2213;20;380;400;1
26;4;empathy;2469;380;60;440;1
26;5;empathy;1923;220;320;540;1
26;6;empathy;1135;40;380;420;1
26;7;reciprocity;3529;340;180;520;1
26;9;reciprocity;1231;180;340;520;1
26;10;empathy;1784;280;280;560;0
26;11;empathy;1770;20;380;400;1
26;12;empathy;2557;380;60;440;1
26;13;empathy;1989;340;180;520;1
26;14;empathy;1490;40;380;420;1
26;15;empathy;3437;380;40;420;1
26;17;empathy;2329;380;100;480;1
26;18;empathy;1518;100;380;480;1
26;19;reciprocity;2718;340;180;520;1
26;20;reciprocity;1999;220;320;540;1
26;21;reciprocity;2232;40;380;420;1
26;22;empathy;1394;180;340;520;1
26;23;empathy;1607;300;240;540;1
26;24;empathy;1659;120;360;480;1
26;25;reciprocity;1704;380;40;420;1
26;26;reciprocity;1041;100;380;480;1
26;28;empathy;1771;280;280;560;0
26;29;empathy;1263;300;240;540;1
26;31;reciprocity;1859;380;20;400;1
26;32;reciprocity;2609;100;380;480;1
26;33;reciprocity;1709;60;380;440;1
26;34;reciprocity;1963;360;160;520;1
26;35;reciprocity;1432;380;100;480;1
26;36;reciprocity;1451;300;240;540;1
26;37;empathy;2451;20;380;400;1
26;38;empathy;2037;120;360;480;1
26;39;empathy;1382;240;300;540;1
26;40;reciprocity;2608;360;120;480;1
26;41;reciprocity;1160;320;220;540;1
26;42;reciprocity;987;240;300;540;1
26;43;reciprocity;1547;220;320;540;1
26;44;reciprocity;2903;280;280;560;0
26;45;reciprocity;3232;380;100;480;1
26;46;reciprocity;1564;40;380;420;1
26;47;reciprocity;1378;240;300;540;1
26;48;reciprocity;1553;120;360;480;1
26;49;empathy;2142;360;120;480;1
26;50;empathy;1079;380;40;420;0
26;51;empathy;1424;180;340;520;1
26;52;reciprocity;2308;60;380;440;1
26;53;reciprocity;1363;20;380;400;1
26;54;reciprocity;980;160;360;520;1
26;55;empathy;1146;160;360;520;1
26;56;empathy;2016;60;380;440;1
26;57;empathy;1101;220;320;540;0
26;58;empathy;1713;160;360;520;1
26;59;empathy;1444;380;100;480;1
26;61;empathy;3420;380;20;400;1
26;62;empathy;1570;360;160;520;1
26;63;empathy;1541;320;220;540;1
26;64;empathy;1272;240;300;540;1
26;65;empathy;2160;360;120;480;1
26;66;empathy;1281;60;380;440;1
26;69;reciprocity;1429;120;360;480;0
26;70;reciprocity;2198;360;160;520;0
26;71;reciprocity;3049;380;40;420;0
26;72;reciprocity;2433;160;360;520;1
26;73;empathy;2176;340;180;520;1
26;74;empathy;2236;320;220;540;1
26;75;empathy;2244;380;20;400;1
26;76;empathy;1241;360;160;520;1
26;78;empathy;1600;100;380;480;1
26;79;reciprocity;1577;300;240;540;0
26;80;reciprocity;2306;380;60;440;0
26;81;reciprocity;2175;360;120;480;0
26;83;reciprocity;1958;280;280;560;1
26;84;reciprocity;2469;380;20;400;0
27;1;empathy;2339;180;340;520;1
27;2;empathy;2695;20;380;400;0
27;3;empathy;1380;100;380;480;1
27;4;empathy;1947;100;380;480;1
27;6;empathy;2289;380;20;400;0
27;8;reciprocity;3303;300;240;540;1
27;9;reciprocity;2621;380;40;420;0
27;10;empathy;2467;220;320;540;1
27;11;empathy;2234;320;220;540;1
27;12;empathy;2023;380;20;400;1
27;13;reciprocity;2652;380;20;400;1
27;14;reciprocity;2110;180;340;520;0
27;15;reciprocity;2144;360;160;520;1
27;16;reciprocity;1196;360;160;520;1
27;17;reciprocity;3406;320;220;540;0
27;18;reciprocity;2517;280;280;560;1
27;20;reciprocity;1977;380;100;480;1
27;21;reciprocity;1654;380;20;400;1
27;22;reciprocity;2435;380;40;420;1
27;23;reciprocity;1577;340;180;520;1
27;24;reciprocity;3859;280;280;560;1
27;25;empathy;1395;120;360;480;1
27;26;empathy;1952;380;100;480;1
27;27;empathy;1293;180;340;520;1
27;28;empathy;2763;340;180;520;0
27;29;empathy;2537;380;100;480;1
27;30;empathy;1046;240;300;540;1
27;31;empathy;1518;380;60;440;1
27;33;empathy;1231;40;380;420;1
27;34;reciprocity;1702;300;240;540;0
27;35;reciprocity;1750;220;320;540;1
27;36;reciprocity;1329;340;180;520;0
27;37;empathy;1258;300;240;540;1
27;39;empathy;936;160;360;520;1
27;40;empathy;3276;340;180;520;1
27;41;empathy;1495;360;120;480;1
27;42;empathy;3498;220;320;540;0
27;43;empathy;1570;320;220;540;1
27;44;empathy;1552;60;380;440;1
27;45;empathy;1715;360;120;480;1
27;46;reciprocity;1708;60;380;440;0
27;47;reciprocity;2276;220;320;540;1
27;48;reciprocity;2168;360;120;480;0
27;50;empathy;1201;160;360;520;1
27;51;empathy;1399;360;160;520;1
27;52;empathy;1111;120;360;480;1
27;53;empathy;1807;20;380;400;1
27;54;empathy;2569;300;240;540;1
27;55;reciprocity;1118;180;340;520;1
27;56;reciprocity;2472;380;100;480;0
27;58;empathy;997;360;160;520;1
27;59;empathy;963;280;280;560;1
27;61;reciprocity;2136;240;300;540;1
27;62;reciprocity;2474;60;380;440;1
27;63;reciprocity;3144;20;380;400;0
27;64;reciprocity;1311;40;380;420;0
27;66;reciprocity;1320;240;300;540;0
27;67;reciprocity;1596;120;360;480;0
27;68;reciprocity;1267;100;380;480;1
27;69;reciprocity;1534;120;360;480;1
27;70;reciprocity;1262;160;360;520;0
27;71;reciprocity;1168;100;380;480;1
27;72;reciprocity;1074;40;380;420;1
27;73;empathy;830;380;40;420;1
27;74;empathy;1107;280;280;560;1
27;75;empathy;1612;380;40;420;1
27;76;empathy;1212;60;380;440;1
27;77;empathy;1416;380;60;440;0
27;78;empathy;1013;40;380;420;1
27;80;reciprocity;1779;320;220;540;1
27;81;reciprocity;1083;360;120;480;1
27;82;reciprocity;1511;20;380;400;0
27;83;reciprocity;1205;380;60;440;0
27;84;reciprocity;2165;380;60;440;0
28;1;reciprocity;1746;360;160;520;1
28;2;reciprocity;1183;100;380;480;1
28;3;reciprocity;1251;360;120;480;1
28;4;reciprocity;835;360;120;480;1
28;5;reciprocity;840;380;100;480;1
28;6;reciprocity;811;60;380;440;1
28;7;reciprocity;738;220;320;540;1
28;8;reciprocity;1322;240;300;540;1
28;9;reciprocity;1852;240;300;540;1
28;10;empathy;2783;380;100;480;1
28;11;empathy;3211;360;120;480;1
28;12;empathy;823;40;380;420;1
28;13;empathy;1185;180;340;520;1
28;14;empathy;1224;180;340;520;1
28;15;empathy;1047;120;360;480;1
28;16;reciprocity;2523;320;220;540;1
28;19;empathy;1026;100;380;480;1
28;20;empathy;966;20;380;400;1
28;21;empathy;962;160;360;520;1
28;22;reciprocity;1480;280;280;560;1
28;23;reciprocity;1054;120;360;480;0
28;24;reciprocity;2071;180;340;520;1
28;25;empathy;1983;20;380;400;1
28;26;empathy;997;300;240;540;1
28;27;empathy;1695;340;180;520;1
28;28;empathy;1330;360;160;520;1
28;29;empathy;1081;320;220;540;1
28;31;reciprocity;2038;380;40;420;1
28;32;reciprocity;1681;380;20;400;0
28;33;reciprocity;1256;100;380;480;1
28;34;reciprocity;2568;300;240;540;1
28;35;reciprocity;1299;20;380;400;1
28;36;reciprocity;1509;320;220;540;1
28;37;empathy;2274;380;40;420;1
28;38;empathy;1227;320;220;540;1
28;39;empathy;1046;60;380;440;1
28;40;reciprocity;1532;180;340;520;1
28;41;reciprocity;1329;160;360;520;0
28;42;reciprocity;1565;40;380;420;0
28;43;empathy;1367;380;60;440;0
28;44;empathy;796;280;280;560;1
28;45;empathy;1659;380;20;400;1
28;46;reciprocity;846;280;280;560;1
28;47;reciprocity;770;160;360;520;1
28;48;reciprocity;2760;380;100;480;1
28;49;reciprocity;889;220;320;540;1
28;51;reciprocity;2056;300;240;540;0
28;52;reciprocity;1516;380;20;400;1
28;53;reciprocity;1016;40;380;420;1
28;54;reciprocity;1007;340;180;520;1
28;55;empathy;2387;360;120;480;1
28;57;empathy;1179;380;20;400;0
28;59;reciprocity;1169;360;160;520;1
28;60;reciprocity;3340;380;40;420;0
28;62;reciprocity;1728;340;180;520;1
28;63;reciprocity;1011;20;380;400;1
28;65;empathy;1675;380;40;420;1
28;66;empathy;1612;360;160;520;1
28;67;reciprocity;1191;380;60;440;1
28;68;reciprocity;1106;120;360;480;1
28;69;reciprocity;1464;60;380;440;1
28;70;empathy;2515;340;180;520;1
28;71;empathy;679;220;320;540;1
28;72;empathy;1284;240;300;540;1
28;73;empathy;937;60;380;440;1
28;74;empathy;1535;280;280;560;1
28;76;empathy;812;100;380;480;1
28;77;empathy;759;160;360;520;1
28;78;empathy;668;40;380;420;1
28;79;empathy;924;380;100;480;1
28;80;empathy;773;120;360;480;1
28;81;empathy;1259;300;240;540;1
28;82;empathy;1468;240;300;540;1
28;83;empathy;1154;220;320;540;1
28;84;empathy;2594;380;60;440;1
29;1;empathy;1433;320;220;540;1
29;3;empathy;1910;160;360;520;1
29;4;empathy;2231;240;300;540;1
29;5;empathy;2290;20;380;400;1
29;7;empathy;3759;380;100;480;1
29;8;empathy;2391;180;340;520;1
29;9;empathy;3852;360;160;520;1
29;11;reciprocity;1894;360;120;480;1
29;13;reciprocity;3680;180;340;520;1
29;14;reciprocity;1702;240;300;540;1
29;15;reciprocity;3372;280;280;560;1
29;16;reciprocity;1563;300;240;540;1
29;17;reciprocity;1513;100;380;480;1
29;18;reciprocity;1539;20;380;400;1
29;19;empathy;1868;40;380;420;1
29;21;empathy;1480;160;360;520;1
29;22;empathy;2302;380;60;440;1
29;24;empathy;1817;60;380;440;1
29;25;reciprocity;3515;360;160;520;1
29;26;reciprocity;3036;380;60;440;0
29;27;reciprocity;2668;40;380;420;1
29;29;reciprocity;2636;380;20;400;0
29;30;reciprocity;2512;120;360;480;1
29;31;empathy;2014;180;340;520;1
29;32;empathy;2056;280;280;560;1
29;33;empathy;1263;100;380;480;1
29;34;reciprocity;1864;120;360;480;1
29;35;reciprocity;1544;220;320;540;1
29;36;reciprocity;1216;160;360;520;1
29;38;reciprocity;2271;380;100;480;1
29;39;reciprocity;1199;40;380;420;1
29;40;reciprocity;1399;320;220;540;1
29;41;reciprocity;1284;60;380;440;1
29;43;empathy;1049;60;380;440;1
29;44;empathy;3304;360;120;480;0
29;45;empathy;935;380;100;480;1
29;46;reciprocity;1320;180;340;520;1
29;47;reciprocity;1010;240;300;540;1
29;48;reciprocity;3044;380;40;420;1
29;49;empathy;161;380;40;420;0
29;50;empathy;1860;100;380;480;1
29;51;empathy;1367;220;320;540;1
29;52;reciprocity;1865;220;320;540;1
29;54;reciprocity;2298;380;100;480;1
29;55;empathy;1361;360;160;520;1
29;56;empathy;853;320;220;540;1
29;57;empathy;1181;220;320;540;1
29;58;empathy;1703;120;360;480;1
29;59;empathy;1582;380;20;400;1
29;61;reciprocity;1301;20;380;400;1
29;62;reciprocity;962;340;180;520;1
29;63;reciprocity;1445;380;60;440;1
29;64;empathy;851;300;240;540;1
29;65;empathy;903;120;360;480;1
29;66;empathy;1629;240;300;540;0
29;67;empathy;1267;40;380;420;1
29;68;empathy;779;20;380;400;1
29;69;empathy;1384;280;280;560;1
29;70;reciprocity;1351;280;280;560;1
29;71;reciprocity;1544;160;360;520;1
29;72;reciprocity;817;100;380;480;1
29;73;empathy;1226;340;180;520;1
29;74;empathy;1266;300;240;540;1
29;75;empathy;999;360;120;480;1
29;76;reciprocity;1561;380;40;420;1
29;78;reciprocity;2226;300;240;540;1
29;79;reciprocity;1071;360;160;520;1
29;80;reciprocity;1297;60;380;440;1
29;81;reciprocity;2318;360;120;480;1
29;82;empathy;2993;380;40;420;1
29;83;empathy;1789;340;180;520;1
29;84;empathy;1496;380;60;440;1
30;1;empathy;1855;300;240;540;1
30;3;empathy;2016;340;180;520;1
30;4;reciprocity;1625;300;240;540;1
30;5;reciprocity;1971;380;100;480;1
30;6;reciprocity;1062;320;220;540;1
30;7;reciprocity;1465;240;300;540;1
30;8;reciprocity;1920;120;360;480;1
30;9;reciprocity;1420;160;360;520;1
30;11;reciprocity;1067;180;340;520;1
30;12;reciprocity;1496;40;380;420;1
30;13;empathy;1066;280;280;560;1
30;14;empathy;1003;120;360;480;1
30;15;empathy;2487;380;40;420;1
30;16;reciprocity;1008;300;240;540;1
30;17;reciprocity;823;120;360;480;1
30;18;reciprocity;1077;380;20;400;0
30;19;reciprocity;1466;380;60;440;1
30;20;reciprocity;1631;360;160;520;1
30;21;reciprocity;1141;160;360;520;1
30;22;empathy;1296;40;380;420;1
30;23;empathy;1125;280;280;560;1
30;24;empathy;999;100;380;480;1
30;25;empathy;1022;20;380;400;1
30;26;empathy;928;380;20;400;0
30;27;empathy;1336;320;220;540;1
30;28;empathy;1373;60;380;440;1
30;29;empathy;1656;360;120;480;1
30;30;empathy;1128;180;340;520;1
30;31;reciprocity;1148;320;220;540;1
30;32;reciprocity;874;20;380;400;1
30;33;reciprocity;1124;360;160;520;1
30;34;empathy;1144;20;380;400;1
30;35;empathy;1183;300;240;540;1
30;36;empathy;1193;240;300;540;1
30;37;empathy;968;180;340;520;1
30;38;empathy;862;220;320;540;1
30;40;reciprocity;2346;340;180;520;1
30;41;reciprocity;1193;60;380;440;1
30;42;reciprocity;2073;360;120;480;1
30;44;empathy;1734;380;60;440;1
30;45;empathy;938;380;100;480;1
30;47;reciprocity;920;360;120;480;1
30;48;reciprocity;2284;380;100;480;1
30;49;reciprocity;849;40;380;420;1
30;50;reciprocity;1652;380;20;400;1
30;51;reciprocity;1494;380;40;420;1
30;52;reciprocity;967;280;280;560;1
30;53;reciprocity;1389;220;320;540;1
30;54;reciprocity;1273;240;300;540;1
30;55;reciprocity;2000;380;60;440;1
30;56;reciprocity;963;20;380;400;1
30;58;empathy;1040;320;220;540;1
30;59;empathy;848;120;360;480;1
30;60;empathy;998;60;380;440;1
30;61;empathy;1434;360;120;480;1
30;62;empathy;1137;360;160;520;1
30;63;empathy;1388;380;60;440;1
30;64;empathy;942;40;380;420;1
30;65;empathy;2098;380;20;400;1
30;66;empathy;764;240;300;540;1
30;67;reciprocity;1155;280;280;560;1
30;68;reciprocity;780;100;380;480;1
30;69;reciprocity;786;220;320;540;1
30;70;reciprocity;786;340;180;520;1
30;71;reciprocity;1004;100;380;480;1
30;72;reciprocity;1593;180;340;520;0
30;73;empathy;1873;380;40;420;0
30;74;empathy;978;100;380;480;0
30;75;empathy;748;220;320;540;0
30;76;empathy;863;160;360;520;1
30;77;empathy;1284;160;360;520;1
30;78;empathy;1322;380;100;480;1
30;80;empathy;1086;360;160;520;1
30;81;empathy;1173;340;180;520;1
30;83;reciprocity;1217;380;40;420;1
30;84;reciprocity;962;60;380;440;1
31;2;multi-motive;1677;360;120;480;1
31;3;multi-motive;1753;380;100;480;1
31;4;multi-motive;1683;360;160;520;1
31;5;multi-motive;1518;100;380;480;1
31;6;multi-motive;1157;320;220;540;1
31;7;control;2024;380;20;400;0
31;8;control;1764;300;240;540;1
31;9;control;2012;100;380;480;1
31;10;multi-motive;803;160;360;520;1
31;11;multi-motive;1832;280;280;560;1
31;12;multi-motive;1705;300;240;540;1
31;13;control;2173;180;340;520;1
31;14;control;2291;120;360;480;1
31;15;control;1454;220;320;540;1
31;16;multi-motive;1303;220;320;540;1
31;17;multi-motive;1764;180;340;520;1
31;18;multi-motive;1335;160;360;520;1
31;19;multi-motive;1226;40;380;420;1
31;20;multi-motive;949;60;380;440;1
31;21;multi-motive;1344;360;120;480;1
31;22;control;1754;240;300;540;1
31;23;control;1683;380;60;440;0
31;24;control;1687;320;220;540;1
31;25;control;1122;160;360;520;1
31;26;control;1728;220;320;540;1
31;27;control;2483;380;40;420;0
31;28;control;1060;180;340;520;1
31;29;control;1478;280;280;560;1
31;30;control;2311;360;160;520;1
31;33;multi-motive;1063;100;380;480;1
31;34;control;1541;360;160;520;1
31;35;control;1726;380;60;440;1
31;36;control;1981;380;100;480;1
31;37;multi-motive;952;360;160;520;1
31;38;multi-motive;1394;60;380;440;1
31;40;multi-motive;1011;220;320;540;1
31;41;multi-motive;770;240;300;540;1
31;42;multi-motive;1078;340;180;520;1
31;43;control;1361;320;220;540;1
31;44;control;1961;160;360;520;1
31;46;multi-motive;1024;300;240;540;1
31;47;multi-motive;1611;180;340;520;1
31;48;multi-motive;2627;340;180;520;1
31;49;multi-motive;712;40;380;420;1
31;50;multi-motive;1633;380;20;400;0
31;51;multi-motive;1417;380;20;400;1
31;52;control;2094;20;380;400;1
31;55;control;2025;300;240;540;0
31;56;control;795;280;280;560;1
31;57;control;1959;120;360;480;1
31;58;multi-motive;1017;380;40;420;1
31;59;multi-motive;1820;380;100;480;1
31;60;multi-motive;1027;20;380;400;1
31;61;multi-motive;1528;120;360;480;1
31;62;multi-motive;1305;120;360;480;1
31;63;multi-motive;906;240;300;540;1
31;64;control;1838;360;120;480;0
31;65;control;1862;380;20;400;1
31;66;control;1319;240;300;540;1
31;67;control;1460;60;380;440;1
31;68;control;2515;380;40;420;1
31;69;control;1124;40;380;420;1
31;70;control;1958;20;380;400;1
31;71;control;1737;360;120;480;1
31;72;control;1898;380;100;480;1
31;73;control;2253;340;180;520;1
31;75;control;1581;60;380;440;1
31;76;multi-motive;745;380;60;440;1
31;77;multi-motive;1185;20;380;400;1
31;78;multi-motive;1001;280;280;560;1
31;79;control;1541;340;180;520;1
31;80;control;1300;100;380;480;1
31;81;control;1405;40;380;420;1
31;82;multi-motive;1171;320;220;540;1
31;83;multi-motive;1692;380;60;440;1
31;84;multi-motive;1333;380;40;420;1
32;1;control;1471;120;360;480;1
32;3;control;2542;100;380;480;1
32;4;multi-motive;2215;380;60;440;0
32;5;multi-motive;3651;240;300;540;1
32;6;multi-motive;2409;340;180;520;0
32;8;multi-motive;1980;340;180;520;1
32;9;multi-motive;2980;380;20;400;0
32;10;multi-motive;1883;180;340;520;1
32;11;multi-motive;1596;320;220;540;1
32;12;multi-motive;3134;300;240;540;1
32;13;multi-motive;2039;160;360;520;1
32;15;multi-motive;3663;380;100;480;0
32;16;multi-motive;2569;380;40;420;0
32;17;multi-motive;1908;100;380;480;1
32;18;multi-motive;2043;220;320;540;1
32;19;multi-motive;3079;100;380;480;1
32;20;multi-motive;2212;120;360;480;1
32;21;multi-motive;1798;40;380;420;1
32;22;control;2028;360;160;520;0
32;23;control;1383;60;380;440;1
32;25;control;3042;380;100;480;0
32;26;control;1951;280;280;560;1
32;27;control;2103;40;380;420;1
32;28;control;2766;320;220;540;1
32;29;control;2193;300;240;540;1
32;30;control;1917;220;320;540;1
32;31;control;1393;40;380;420;1
32;32;control;2360;240;300;540;1
32;33;control;2207;380;40;420;0
32;34;multi-motive;1962;360;120;480;1
32;35;multi-motive;1684;120;360;480;1
32;36;multi-motive;1680;380;20;400;0
32;37;control;2791;380;20;400;0
32;38;control;1749;380;60;440;0
32;39;control;2123;380;40;420;0
32;40;control;1704;220;320;540;1
32;41;control;1892;180;340;520;1
32;42;control;1320;100;380;480;1
32;43;control;1833;240;300;540;1
32;45;control;2109;20;380;400;1
32;46;multi-motive;1545;40;380;420;1
32;47;multi-motive;2855;380;60;440;1
32;48;multi-motive;2823;360;120;480;0
32;49;control;3171;380;60;440;0
32;50;control;1769;160;360;520;1
32;51;control;2741;360;120;480;0
32;52;control;986;20;380;400;1
32;53;control;2448;340;180;520;0
32;54;control;1604;180;340;520;1
32;55;control;3344;300;240;540;0
32;56;control;2409;280;280;560;1
32;57;control;2986;320;220;540;0
32;59;multi-motive;1645;180;340;520;1
32;60;multi-motive;2444;20;380;400;1
32;62;multi-motive;1168;20;380;400;1
32;63;multi-motive;1845;160;360;520;1
32;64;multi-motive;1845;300;240;540;1
32;65;multi-motive;1378;280;280;560;1
32;66;multi-motive;2376;320;220;540;1
32;67;multi-motive;1134;60;380;440;1
32;68;multi-motive;2825;360;160;520;1
32;69;multi-motive;2491;220;320;540;1
32;70;multi-motive;1335;240;300;540;1
32;71;multi-motive;2807;60;380;440;1
32;73;multi-motive;2346;380;40;420;1
32;74;multi-motive;2058;280;280;560;1
32;75;multi-motive;3778;380;100;480;1
32;76;control;1684;60;380;440;1
32;77;control;1929;160;360;520;1
32;79;control;2042;380;20;400;0
32;80;control;1556;120;360;480;1
32;81;control;2524;340;180;520;0
32;82;control;1698;360;120;480;0
32;83;control;1976;360;160;520;1
32;84;control;3470;380;100;480;0
33;1;multi-motive;2941;240;300;540;1
33;3;multi-motive;3932;220;320;540;1
33;4;control;2582;380;40;420;0
33;5;control;2348;180;340;520;1
33;7;control;2136;160;360;520;1
33;9;control;2264;340;180;520;0
33;11;multi-motive;2697;20;380;400;1
33;12;multi-motive;2298;180;340;520;1
33;13;multi-motive;2198;120;360;480;1
33;14;multi-motive;2335;120;360;480;1
33;15;multi-motive;1869;60;380;440;1
33;16;control;2864;100;380;480;1
33;17;control;2865;280;280;560;1
33;18;control;2696;240;300;540;1
33;20;control;1268;120;360;480;1
33;21;control;2465;220;320;540;1
33;23;multi-motive;2330;340;180;520;0
33;24;multi-motive;2581;280;280;560;0
33;25;control;2837;300;240;540;1
33;26;control;2098;360;120;480;1
33;27;control;1951;20;380;400;0
33;28;control;3198;380;100;480;0
33;29;control;3563;380;60;440;0
33;30;control;3495;300;240;540;1
33;31;control;3368;360;160;520;1
33;32;control;1470;40;380;420;1
33;33;control;2345;180;340;520;1
33;34;multi-motive;1032;60;380;440;1
33;35;multi-motive;1031;100;380;480;1
33;37;control;1130;20;380;400;1
33;38;control;2738;380;20;400;0
33;39;control;2117;360;160;520;0
33;40;multi-motive;1118;180;340;520;1
33;41;multi-motive;3553;380;20;400;0
33;42;multi-motive;2329;380;60;440;0
33;43;control;2753;280;280;560;1
33;44;control;1946;360;120;480;0
33;45;control;1090;120;360;480;1
33;46;control;1834;380;60;440;0
33;47;control;2090;380;100;480;0
33;48;control;2137;380;20;400;0
33;49;multi-motive;1720;160;360;520;1
33;50;multi-motive;2464;380;60;440;0
33;51;multi-motive;892;320;220;540;1
33;52;multi-motive;2542;380;40;420;0
33;53;multi-motive;1495;100;380;480;1
33;54;multi-motive;1599;380;40;420;0
33;55;multi-motive;1798;360;120;480;0
33;56;multi-motive;1614;360;120;480;0
33;57;multi-motive;3973;320;220;540;1
33;58;multi-motive;1251;380;20;400;0
33;59;multi-motive;3349;300;240;540;1
33;60;multi-motive;1107;240;300;540;1
33;61;control;2312;380;40;420;0
33;62;control;1713;320;220;540;1
33;64;control;1043;100;380;480;1
33;65;control;992;240;300;540;1
33;66;control;1695;320;220;540;1
33;67;control;982;60;380;440;1
33;68;control;1335;340;180;520;1
33;69;control;1012;160;360;520;1
33;70;multi-motive;2157;380;100;480;0
33;71;multi-motive;1250;360;160;520;0
33;72;multi-motive;923;20;380;400;1
33;74;multi-motive;1056;160;360;520;1
33;75;multi-motive;1311;40;380;420;1
33;76;control;1053;60;380;440;1
33;77;control;1126;220;320;540;1
33;78;control;764;40;380;420;1
33;79;multi-motive;874;300;240;540;1
33;80;multi-motive;882;220;320;540;1
33;81;multi-motive;2015;380;100;480;0
33;82;multi-motive;738;40;380;420;1
1;1;reciprocity;928;380;40;420;1
1;2;reciprocity;1087;40;380;420;1
1;3;reciprocity;697;240;300;540;1
1;4;reciprocity;964;380;60;440;1
1;5;reciprocity;762;280;280;560;1
1;6;reciprocity;1005;180;340;520;1
1;7;empathy;967;380;20;400;1
1;8;empathy;757;40;380;420;1
1;10;empathy;855;340;180;520;1
1;11;empathy;807;380;60;440;1
1;12;empathy;875;320;220;540;1
1;13;reciprocity;651;360;160;520;1
1;14;reciprocity;809;20;380;400;1
1;15;reciprocity;892;120;360;480;1
1;17;empathy;658;220;320;540;1
1;19;empathy;894;160;360;520;1
1;20;empathy;720;120;360;480;1
1;22;empathy;895;220;320;540;1
1;23;empathy;797;380;20;400;1
1;24;empathy;1089;240;300;540;1
1;25;empathy;710;380;40;420;1
1;26;empathy;654;20;380;400;1
1;27;empathy;883;20;380;400;1
1;28;empathy;544;300;240;540;1
1;29;empathy;659;60;380;440;1
1;31;reciprocity;816;40;380;420;1
1;32;reciprocity;597;160;360;520;1
1;34;reciprocity;657;340;180;520;1
1;35;reciprocity;695;60;380;440;1
1;36;reciprocity;1622;340;180;520;1
1;37;empathy;788;320;220;540;1
1;38;empathy;742;360;120;480;1
1;39;empathy;1058;380;40;420;1
1;40;empathy;697;360;160;520;1
1;41;empathy;654;280;280;560;1
1;42;empathy;839;120;360;480;1
1;43;empathy;843;240;300;540;1
1;44;empathy;808;160;360;520;1
1;45;empathy;690;40;380;420;1
1;46;empathy;830;380;60;440;1
1;47;empathy;782;100;380;480;1
1;48;empathy;969;360;120;480;1
1;49;empathy;823;340;180;520;1
1;50;empathy;906;60;380;440;1
1;51;empathy;858;100;380;480;1
1;52;reciprocity;975;380;100;480;1
1;53;reciprocity;841;320;220;540;1
1;54;reciprocity;929;280;280;560;1
1;55;reciprocity;844;20;380;400;1
1;57;reciprocity;1070;180;340;520;1
1;58;reciprocity;762;360;120;480;1
1;59;reciprocity;1284;100;380;480;1
1;60;reciprocity;801;380;60;440;1
1;61;empathy;696;180;340;520;1
1;62;empathy;722;280;280;560;1
1;63;empathy;617;180;340;520;1
1;65;reciprocity;1377;360;120;480;1
1;66;reciprocity;988;300;240;540;1
1;67;reciprocity;1171;380;20;400;1
1;68;reciprocity;1771;320;220;540;1
1;69;reciprocity;905;380;40;420;1
1;70;reciprocity;573;240;300;540;1
1;71;reciprocity;728;300;240;540;1
1;72;reciprocity;651;360;160;520;1
1;73;reciprocity;816;60;380;440;1
1;74;reciprocity;677;220;320;540;1
1;75;reciprocity;1056;380;20;400;1
1;77;reciprocity;757;100;380;480;1
1;78;reciprocity;849;220;320;540;1
1;79;empathy;705;300;240;540;1
1;80;empathy;836;380;100;480;1
1;81;empathy;674;360;160;520;1
1;82;reciprocity;739;160;360;520;1
1;83;reciprocity;734;120;360;480;1
1;84;reciprocity;733;380;100;480;1
2;1;control;2089;380;40;420;1
2;2;control;1195;380;40;420;0
2;3;control;2642;380;60;440;1
2;4;control;1128;380;100;480;1
2;5;control;2345;20;380;400;0
2;6;control;1059;160;360;520;1
2;7;multi-motive;1290;380;60;440;1
2;8;multi-motive;2094;380;60;440;1
2;9;multi-motive;1134;320;220;540;1
2;10;multi-motive;1858;380;20;400;1
2;11;multi-motive;919;120;360;480;1
2;14;control;1273;100;380;480;1
2;15;control;1418;160;360;520;1
2;16;control;1301;360;160;520;0
2;17;control;1124;300;240;540;1
2;18;control;1535;340;180;520;1
2;19;control;1390;180;340;520;1
2;20;control;1091;120;360;480;1
2;21;control;1190;220;320;540;1
2;22;multi-motive;1775;380;20;400;1
2;23;multi-motive;1042;100;380;480;1
2;24;multi-motive;1033;280;280;560;1
2;25;control;1619;380;60;440;0
2;26;control;1266;100;380;480;1
2;27;control;2449;380;20;400;0
2;28;multi-motive;1452;380;100;480;1
2;29;multi-motive;1552;380;40;420;1
2;30;multi-motive;1619;380;100;480;1
2;31;control;1362;340;180;520;0
2;32;control;1710;60;380;440;1
2;33;control;1748;360;160;520;1
2;35;multi-motive;1481;340;180;520;0
2;36;multi-motive;1554;220;320;540;1
2;37;control;947;20;380;400;1
2;38;control;3370;280;280;560;1
2;40;control;1722;300;240;540;1
2;41;control;1335;360;120;480;0
2;42;control;1568;360;120;480;0
2;43;multi-motive;1658;320;220;540;1
2;45;multi-motive;2035;360;120;480;1
2;46;multi-motive;1060;160;360;520;1
2;47;multi-motive;848;180;340;520;1
2;48;multi-motive;1119;280;280;560;1
2;49;control;1895;120;360;480;1
2;50;control;1659;60;380;440;1
2;51;control;1528;380;100;480;0
2;53;control;1984;180;340;520;1
2;54;control;1161;220;320;540;0
2;55;multi-motive;2263;380;40;420;1
2;56;multi-motive;1045;220;320;540;1
2;57;multi-motive;1377;300;240;540;1
2;58;multi-motive;978;60;380;440;1
2;59;multi-motive;1452;360;160;520;1
2;60;multi-motive;1413;180;340;520;1
2;61;multi-motive;1226;240;300;540;1
2;62;multi-motive;1626;120;360;480;1
2;63;multi-motive;1299;360;160;520;0
2;64;multi-motive;1283;20;380;400;1
2;65;multi-motive;1294;300;240;540;1
2;66;multi-motive;1872;60;380;440;1
2;67;multi-motive;1704;240;300;540;1
2;68;multi-motive;1429;340;180;520;1
2;69;multi-motive;1200;40;380;420;1
2;70;control;1375;240;300;540;1
2;71;control;1839;280;280;560;1
2;72;control;1296;240;300;540;1
2;73;multi-motive;1275;20;380;400;1
2;75;multi-motive;1215;40;380;420;1
2;76;control;1299;320;220;540;1
2;77;control;1555;320;220;540;1
2;78;control;1865;40;380;420;1
2;79;control;1609;380;20;400;1
2;80;control;1224;40;380;420;1
2;82;multi-motive;2143;100;380;480;1
2;83;multi-motive;1641;360;120;480;1
2;84;multi-motive;1284;160;360;520;1
3;1;control;1209;380;40;420;0
3;2;control;1718;180;340;520;1
3;3;control;1297;100;380;480;1
3;5;multi-motive;2349;20;380;400;1
3;6;multi-motive;1803;60;380;440;0
3;7;multi-motive;1548;340;180;520;0
3;8;multi-motive;1662;380;40;420;0
3;9;multi-motive;945;100;380;480;1
3;10;control;1460;280;280;560;1
3;11;control;1158;380;100;480;0
3;12;control;1353;380;20;400;0
3;13;control;1281;380;40;420;0
3;14;control;1904;360;160;520;0
3;16;control;2353;380;100;480;0
3;17;control;1706;360;120;480;0
3;18;control;1361;60;380;440;1
3;19;control;1408;60;380;440;1
3;20;control;1514;380;60;440;0
3;21;control;1924;300;240;540;1
3;23;multi-motive;2270;300;240;540;0
3;24;multi-motive;1604;220;320;540;0
3;25;multi-motive;1376;40;380;420;1
3;26;multi-motive;2981;320;220;540;0
3;27;multi-motive;2068;240;300;540;0
3;28;control;2169;120;360;480;1
3;29;control;1140;300;240;540;0
3;30;control;1763;20;380;400;1
3;31;multi-motive;1533;280;280;560;1
3;32;multi-motive;3375;380;100;480;0
3;33;multi-motive;1433;220;320;540;1
3;34;multi-motive;1781;160;360;520;0
3;35;multi-motive;1968;180;340;520;1
3;37;multi-motive;1717;380;60;440;0
3;38;multi-motive;2047;280;280;560;0
3;39;multi-motive;2191;380;20;400;0
3;40;multi-motive;1496;20;380;400;1
3;42;multi-motive;1250;360;120;480;0
3;43;control;2161;20;380;400;1
3;44;control;1464;380;20;400;0
3;45;control;1718;160;360;520;1
3;46;control;2861;180;340;520;0
3;47;control;1225;240;300;540;1
3;48;control;1465;320;220;540;0
3;49;multi-motive;1384;380;60;440;0
3;50;multi-motive;1557;160;360;520;1
3;51;multi-motive;1104;360;160;520;0
3;52;control;2163;240;300;540;0
3;53;control;1761;120;360;480;1
3;54;control;2203;360;120;480;1
3;55;multi-motive;2085;380;40;420;0
3;56;multi-motive;813;60;380;440;1
3;57;multi-motive;1391;300;240;540;1
3;58;control;2267;160;360;520;0
3;59;control;2876;380;60;440;0
3;61;multi-motive;1626;120;360;480;1
3;62;multi-motive;2408;100;380;480;1
3;64;multi-motive;1613;120;360;480;0
3;65;multi-motive;1907;320;220;540;0
3;66;multi-motive;1217;340;180;520;0
3;67;control;1832;40;380;420;1
3;68;control;1299;360;160;520;0
3;70;control;2427;100;380;480;1
3;71;control;1003;340;180;520;0
3;72;control;2287;220;320;540;1
3;73;control;2188;340;180;520;0
3;74;control;1366;320;220;540;1
3;75;control;2863;40;380;420;1
3;76;multi-motive;1576;180;340;520;0
3;77;multi-motive;2462;380;20;400;0
3;78;multi-motive;1696;360;160;520;1
3;79;multi-motive;2617;360;120;480;0
3;80;multi-motive;1921;40;380;420;1
3;81;multi-motive;1779;380;100;480;0
3;82;control;2306;280;280;560;1
3;84;control;2538;220;320;540;0
4;1;empathy;2108;100;380;480;1
4;2;empathy;2246;340;180;520;1
4;3;empathy;1911;320;220;540;0
4;4;empathy;2740;280;280;560;0
4;5;empathy;1269;380;40;420;0
4;7;reciprocity;2331;380;100;480;0
4;8;reciprocity;1480;300;240;540;1
4;9;reciprocity;1967;280;280;560;1
4;10;empathy;1367;380;100;480;0
4;11;empathy;2551;340;180;520;1
4;12;empathy;1451;380;40;420;0
4;13;reciprocity;1228;100;380;480;1
4;14;reciprocity;1041;220;320;540;1
4;16;reciprocity;1346;320;220;540;0
4;17;reciprocity;1362;380;20;400;0
4;18;reciprocity;1273;40;380;420;1
4;19;reciprocity;1324;100;380;480;1
4;20;reciprocity;2001;280;280;560;1
4;21;reciprocity;1071;160;360;520;1
4;22;empathy;1418;20;380;400;1
4;23;empathy;1146;220;320;540;1
4;24;empathy;1737;380;100;480;0
4;25;reciprocity;2049;240;300;540;1
4;26;reciprocity;2098;180;340;520;1
4;27;reciprocity;1032;180;340;520;1
4;28;reciprocity;1210;380;60;440;0
4;29;reciprocity;1060;120;360;480;1
4;30;reciprocity;2363;380;40;420;0
4;31;empathy;1973;120;360;480;1
4;32;empathy;2961;360;120;480;0
4;33;empathy;1414;60;380;440;1
4;34;empathy;1675;380;60;440;0
4;35;empathy;1804;300;240;540;1
4;36;empathy;1163;40;380;420;1
4;37;empathy;1287;180;340;520;1
4;38;empathy;1582;60;380;440;0
4;40;reciprocity;2069;380;60;440;0
4;41;reciprocity;1148;60;380;440;1
4;43;reciprocity;2507;120;360;480;1
4;44;reciprocity;3203;380;20;400;0
4;45;reciprocity;974;20;380;400;1
4;46;empathy;2616;240;300;540;1
4;47;empathy;2565;360;160;520;0
4;48;empathy;2217;320;220;540;1
4;49;reciprocity;1871;340;180;520;1
4;50;reciprocity;1516;240;300;540;1
4;51;reciprocity;1681;360;120;480;1
4;52;reciprocity;1348;40;380;420;1
4;53;reciprocity;2697;220;320;540;1
4;54;reciprocity;1758;300;240;540;0
4;55;empathy;1649;160;360;520;1
4;56;empathy;1041;180;340;520;1
4;57;empathy;1005;240;300;540;1
4;58;empathy;1061;160;360;520;1
4;60;empathy;799;20;380;400;1
4;61;empathy;1805;380;20;400;0
4;62;empathy;1663;120;360;480;1
4;63;empathy;2473;40;380;420;1
4;64;reciprocity;1298;380;40;420;0
4;65;reciprocity;2792;380;100;480;0
4;67;reciprocity;1173;160;360;520;1
4;68;reciprocity;1829;20;380;400;1
4;69;reciprocity;2281;360;120;480;0
4;70;reciprocity;1612;360;160;520;1
4;72;reciprocity;965;60;380;440;1
4;73;empathy;1303;100;380;480;1
4;74;empathy;1988;360;160;520;1
4;75;empathy;2167;300;240;540;0
4;76;reciprocity;1714;360;160;520;1
4;77;reciprocity;2508;340;180;520;0
4;78;reciprocity;2158;320;220;540;1
4;79;empathy;1519;280;280;560;0
4;80;empathy;1956;380;20;400;0
4;81;empathy;1344;380;60;440;0
4;82;empathy;1250;360;120;480;0
4;83;empathy;1573;220;320;540;0
5;1;reciprocity;1062;300;240;540;1
5;2;reciprocity;917;360;160;520;1
5;3;reciprocity;1465;220;320;540;1
5;4;empathy;1574;380;100;480;1
5;5;empathy;854;220;320;540;1
5;6;empathy;731;280;280;560;1
5;7;empathy;1052;300;240;540;1
5;8;empathy;969;40;380;420;1
5;11;empathy;1875;380;40;420;1
5;12;empathy;2717;20;380;400;1
5;13;empathy;1215;240;300;540;1
5;14;empathy;883;380;40;420;1
5;15;empathy;906;180;340;520;1
5;16;reciprocity;964;280;280;560;1
5;18;reciprocity;858;20;380;400;1
5;20;empathy;1066;380;100;480;1
5;21;empathy;874;360;120;480;1
5;22;reciprocity;2014;320;220;540;1
5;23;reciprocity;882;380;100;480;1
5;24;reciprocity;1600;280;280;560;1
5;25;reciprocity;1413;380;100;480;1
5;26;reciprocity;808;180;340;520;1
5;27;reciprocity;1096;360;160;520;1
5;28;reciprocity;786;240;300;540;1
5;29;reciprocity;1094;240;300;540;1
5;30;reciprocity;876;120;360;480;1
5;31;reciprocity;867;320;220;540;1
5;32;reciprocity;1603;360;120;480;1
5;33;reciprocity;972;300;240;540;1
5;34;reciprocity;987;160;360;520;1
5;35;reciprocity;1751;380;40;420;1
5;36;reciprocity;2351;380;40;420;1
5;37;reciprocity;806;60;380;440;1
5;38;reciprocity;1278;40;380;420;1
5;39;reciprocity;1252;340;180;520;1
5;40;reciprocity;868;360;120;480;1
5;42;reciprocity;1317;380;60;440;1
5;44;reciprocity;764;40;380;420;1
5;45;reciprocity;2395;380;60;440;0
5;46;empathy;2746;380;60;440;1
5;47;empathy;836;320;220;540;1
5;48;empathy;1682;360;160;520;1
5;49;empathy;913;340;180;520;1
5;51;empathy;1176;60;380;440;1
5;52;reciprocity;2401;380;20;400;1
5;53;reciprocity;956;380;20;400;1
5;54;reciprocity;1548;180;340;520;1
5;55;empathy;954;380;60;440;1
5;56;empathy;769;240;300;540;1
5;57;empathy;768;100;380;480;1
5;58;empathy;1149;120;360;480;1
5;59;empathy;900;220;320;540;1
5;60;empathy;1012;360;120;480;1
5;61;empathy;712;180;340;520;1
5;62;empathy;1573;280;280;560;1
5;63;empathy;676;40;380;420;1
5;64;reciprocity;697;100;380;480;1
5;65;reciprocity;800;100;380;480;1
5;66;reciprocity;779;60;380;440;1
5;67;empathy;660;120;360;480;1
5;68;empathy;527;20;380;400;1
5;69;empathy;1042;100;380;480;1
5;70;reciprocity;767;220;320;540;1
5;71;reciprocity;717;120;360;480;1
5;72;reciprocity;735;160;360;520;1
5;73;reciprocity;644;20;380;400;1
5;74;reciprocity;736;340;180;520;1
5;76;empathy;641;60;380;440;1
5;77;empathy;988;360;160;520;1
5;79;empathy;783;160;360;520;1
5;80;empathy;2181;380;20;400;1
5;81;empathy;876;340;180;520;1
5;82;empathy;736;380;20;400;1
5;83;empathy;706;300;240;540;1
5;84;empathy;905;160;360;520;1
6;1;reciprocity;1054;100;380;480;1
6;3;reciprocity;951;40;380;420;1
6;4;empathy;1306;180;340;520;1
6;6;empathy;1309;220;320;540;1
6;8;empathy;2107;380;20;400;0
6;9;empathy;1824;360;160;520;1
6;10;empathy;1352;380;100;480;1
6;11;empathy;1774;380;40;420;0
6;12;empathy;1792;320;220;540;1
6;13;empathy;1804;360;160;520;1
6;14;empathy;2235;380;40;420;0
6;15;empathy;1159;60;380;440;1
6;16;empathy;1046;180;340;520;1
6;17;empathy;925;300;240;540;1
6;18;empathy;787;220;320;540;1
6;20;empathy;2404;380;100;480;1
6;21;empathy;1601;280;280;560;1
6;22;empathy;1948;380;20;400;0
6;24;empathy;1151;340;180;520;1
6;25;reciprocity;863;180;340;520;1
6;26;reciprocity;1215;120;360;480;1
6;27;reciprocity;789;280;280;560;1
6;28;empathy;873;320;220;540;1
6;29;empathy;873;160;360;520;1
6;30;empathy;718;40;380;420;1
6;31;reciprocity;1185;340;180;520;1
6;32;reciprocity;1097;360;120;480;1
6;33;reciprocity;1654;380;20;400;0
6;34;empathy;882;20;380;400;1
6;35;empathy;1117;280;280;560;1
6;36;empathy;1061;40;380;420;1
6;37;empathy;673;60;380;440;1
6;38;empathy;950;20;380;400;1
6;39;empathy;778;100;380;480;1
6;41;reciprocity;770;120;360;480;1
6;42;reciprocity;1228;60;380;440;1
6;43;reciprocity;1869;380;100;480;1
6;45;reciprocity;1137;280;280;560;1
6;46;reciprocity;2081;380;40;420;0
6;47;reciprocity;935;220;320;540;1
6;48;reciprocity;1283;360;160;520;1
6;49;reciprocity;733;20;380;400;1
6;50;reciprocity;3467;380;60;440;0
6;51;reciprocity;1041;220;320;540;1
6;53;reciprocity;928;300;240;540;1
6;54;reciprocity;812;160;360;520;1
6;55;empathy;2125;380;60;440;0
6;56;empathy;1488;360;120;480;1
6;57;empathy;854;120;360;480;1
6;58;reciprocity;913;40;380;420;1
6;59;reciprocity;1744;380;100;480;1
6;60;reciprocity;894;240;300;540;1
6;61;empathy;882;160;360;520;1
6;62;empathy;1087;340;180;520;1
6;63;empathy;2313;380;60;440;0
6;64;reciprocity;1064;320;220;540;1
6;65;reciprocity;1377;240;300;540;1
6;66;reciprocity;774;160;360;520;1
6;67;empathy;879;300;240;540;1
6;68;empathy;2085;360;120;480;1
6;69;empathy;811;120;360;480;1
6;70;empathy;824;100;380;480;1
6;71;empathy;850;240;300;540;1
6;72;empathy;1276;240;300;540;1
6;73;reciprocity;1746;380;60;440;0
6;74;reciprocity;1761;360;120;480;1
6;75;reciprocity;1712;380;20;400;0
6;76;reciprocity;1821;360;160;520;1
6;77;reciprocity;826;60;380;440;1
6;78;reciprocity;1647;320;220;540;1
6;79;reciprocity;1419;20;380;400;1
6;80;reciprocity;1186;340;180;520;1
6;81;reciprocity;765;100;380;480;1
6;82;reciprocity;2117;380;40;420;0
6;83;reciprocity;1133;180;340;520;1
6;84;reciprocity;1072;300;240;540;1
7;1;empathy;2114;380;20;400;1
7;2;empathy;1312;40;380;420;1
7;3;empathy;1475;20;380;400;1
7;5;empathy;1637;380;100;480;0
7;6;empathy;1391;240;300;540;1
7;8;empathy;2560;340;180;520;0
7;9;empathy;1847;300;240;540;1
7;10;empathy;1852;120;360;480;1
7;11;empathy;1428;60;380;440;1
7;12;empathy;1676;100;380;480;1
7;13;empathy;1564;300;240;540;1
7;14;empathy;2039;380;20;400;0
7;15;empathy;2057;380;100;480;0
7;16;reciprocity;1177;60;380;440;1
7;17;reciprocity;1849;380;40;420;0
7;18;reciprocity;2367;380;20;400;0
7;19;reciprocity;1607;280;280;560;1
7;20;reciprocity;2058;360;120;480;0
7;21;reciprocity;1535;40;380;420;1
7;23;reciprocity;1833;160;360;520;1
7;26;reciprocity;2188;380;100;480;0
7;27;reciprocity;1395;120;360;480;1
7;28;empathy;1964;360;120;480;0
7;29;empathy;1475;100;380;480;1
7;30;empathy;1690;160;360;520;1
7;31;reciprocity;1899;380;20;400;0
7;32;reciprocity;1868;360;160;520;0
7;34;reciprocity;1365;300;240;540;1
7;35;reciprocity;1573;320;220;540;1
7;36;reciprocity;2545;300;240;540;1
7;37;empathy;1253;60;380;440;1
7;38;empathy;1043;20;380;400;1
7;39;empathy;2548;360;120;480;0
7;40;empathy;1372;320;220;540;1
7;41;empathy;2405;380;40;420;0
7;43;reciprocity;1100;20;380;400;1
7;44;reciprocity;1884;340;180;520;0
7;45;reciprocity;1465;100;380;480;1
7;46;reciprocity;1440;240;300;540;1
7;47;reciprocity;1619;20;380;400;1
7;48;reciprocity;1349;100;380;480;1
7;49;reciprocity;1953;380;100;480;0
7;50;reciprocity;1839;380;60;440;0
7;51;reciprocity;1737;360;160;520;1
7;52;empathy;2800;360;160;520;0
7;53;empathy;923;180;340;520;1
7;54;empathy;2186;380;60;440;1
7;55;reciprocity;1405;220;320;540;1
7;56;reciprocity;1121;180;340;520;1
7;57;reciprocity;1545;240;300;540;1
7;58;reciprocity;888;160;360;520;1
7;59;reciprocity;1103;180;340;520;1
7;60;reciprocity;2170;360;120;480;1
7;61;empathy;1418;40;380;420;1
7;62;empathy;1588;280;280;560;1
7;63;empathy;937;220;320;540;1
7;64;reciprocity;1072;220;320;540;1
7;65;reciprocity;1268;120;360;480;1
7;66;reciprocity;1315;60;380;440;1
7;67;reciprocity;2000;320;220;540;0
7;68;reciprocity;2518;380;60;440;0
7;69;reciprocity;1783;380;40;420;0
7;70;empathy;1121;160;360;520;1
7;71;empathy;1716;380;40;420;0
7;73;empathy;963;180;340;520;1
7;74;empathy;869;280;280;560;1
7;75;empathy;2637;340;180;520;0
7;76;empathy;1359;120;360;480;1
7;77;empathy;2080;320;220;540;0
7;78;empathy;1397;240;300;540;1
7;79;empathy;2349;360;160;520;1
7;80;empathy;1924;220;320;540;1
7;81;empathy;2461;380;60;440;0
7;82;reciprocity;1006;40;380;420;1
7;83;reciprocity;1666;280;280;560;1
7;84;reciprocity;1296;340;180;520;1
8;1;control;1219;380;60;440;0
8;2;control;1511;60;380;440;1
8;3;control;1751;380;40;420;0
8;4;control;1469;380;20;400;0
8;6;control;1613;380;20;400;0
8;7;multi-motive;2044;360;120;480;1
8;8;multi-motive;1787;120;360;480;1
8;9;multi-motive;1859;20;380;400;1
8;11;multi-motive;1896;280;280;560;1
8;12;multi-motive;2028;380;40;420;0
8;13;multi-motive;2975;280;280;560;1
8;14;multi-motive;2304;360;160;520;0
8;15;multi-motive;2416;380;40;420;0
8;16;multi-motive;2125;240;300;540;1
8;17;multi-motive;2270;360;120;480;0
8;18;multi-motive;2160;100;380;480;1
8;19;control;2263;320;220;540;0
8;20;control;3108;160;360;520;1
8;22;control;2555;280;280;560;0
8;23;control;2099;20;380;400;1
8;24;control;2070;360;160;520;0
8;25;control;2145;380;60;440;0
8;26;control;1701;300;240;540;1
8;27;control;1937;300;240;540;0
8;28;control;1917;180;340;520;1
8;29;control;2123;360;120;480;0
8;30;control;2497;280;280;560;1
8;31;control;1666;40;380;420;1
8;32;control;2630;340;180;520;0
8;35;control;1690;100;380;480;1
8;37;multi-motive;2402;300;240;540;0
8;38;multi-motive;2224;180;340;520;1
8;39;multi-motive;2153;380;20;400;0
8;40;multi-motive;1641;300;240;540;1
8;41;multi-motive;1983;380;20;400;0
8;42;multi-motive;3293;380;100;480;1
8;43;multi-motive;1956;40;380;420;1
8;44;multi-motive;1907;100;380;480;1
8;45;multi-motive;3167;220;320;540;0
8;46;control;2700;180;340;520;1
8;47;control;1564;380;40;420;0
8;48;control;1503;60;380;440;1
8;49;control;1541;380;100;480;1
8;50;control;2114;360;120;480;0
8;51;control;1901;240;300;540;1
8;52;control;1694;220;320;540;1
8;53;control;2463;100;380;480;1
8;54;control;1578;120;360;480;1
8;55;control;1270;40;380;420;1
8;56;control;2176;220;320;540;0
8;57;control;1862;240;300;540;1
8;58;multi-motive;2483;380;60;440;0
8;59;multi-motive;1981;20;380;400;1
8;60;multi-motive;2656;380;100;480;0
8;62;multi-motive;1715;340;180;520;0
8;63;multi-motive;1596;160;360;520;1
8;64;multi-motive;2055;180;340;520;1
8;65;multi-motive;1577;60;380;440;1
8;66;multi-motive;1668;60;380;440;1
8;67;control;1701;120;360;480;1
8;68;control;2142;20;380;400;1
8;69;control;2055;340;180;520;0
8;70;control;2025;320;220;540;1
8;71;control;2454;360;160;520;0
8;72;control;1522;160;360;520;1
8;73;multi-motive;1912;360;160;520;0
8;74;multi-motive;2334;340;180;520;0
8;75;multi-motive;1975;40;380;420;1
8;76;multi-motive;1530;120;360;480;1
8;77;multi-motive;1438;240;300;540;1
8;78;multi-motive;1806;320;220;540;0
8;80;multi-motive;1748;160;360;520;1
8;81;multi-motive;1483;220;320;540;1
8;82;multi-motive;2447;320;220;540;1
8;84;multi-motive;1900;380;60;440;0
9;1;multi-motive;951;120;360;480;1
9;2;multi-motive;901;40;380;420;1
9;3;multi-motive;1465;220;320;540;1
9;4;multi-motive;851;60;380;440;1
9;5;multi-motive;2091;360;120;480;0
9;6;multi-motive;962;60;380;440;1
9;7;control;883;280;280;560;1
9;8;control;2001;320;220;540;0
9;9;control;1130;320;220;540;1
9;10;control;2279;280;280;560;0
9;11;control;2491;360;120;480;1
9;12;control;706;60;380;440;1
9;14;control;801;120;360;480;1
9;15;control;1391;380;100;480;1
9;16;multi-motive;1154;220;320;540;1
9;17;multi-motive;1172;40;380;420;1
9;18;multi-motive;1638;380;20;400;0
9;20;multi-motive;1219;100;380;480;1
9;21;multi-motive;1288;240;300;540;1
9;23;control;871;20;380;400;1
9;24;control;1576;120;360;480;1
9;25;control;1240;180;340;520;1
9;26;control;1779;300;240;540;0
9;27;control;1390;360;160;520;1
9;28;control;1763;180;340;520;1
9;29;control;1113;20;380;400;1
9;30;control;1165;220;320;540;1
9;31;control;1322;40;380;420;1
9;32;control;1298;300;240;540;1
9;33;control;1319;220;320;540;1
9;34;multi-motive;2396;320;220;540;1
9;36;multi-motive;1034;180;340;520;1
9;38;multi-motive;1390;300;240;540;1
9;39;multi-motive;1172;380;60;440;0
9;40;multi-motive;1120;380;100;480;0
9;41;multi-motive;2199;180;340;520;1
9;42;multi-motive;1282;120;360;480;1
9;43;control;1289;380;100;480;0
9;44;control;1859;380;20;400;0
9;45;control;2312;160;360;520;1
9;46;multi-motive;2243;340;180;520;0
9;47;multi-motive;1659;380;20;400;0
9;48;multi-motive;992;160;360;520;1
9;49;multi-motive;724;20;380;400;1
9;50;multi-motive;1727;360;120;480;0
9;51;multi-motive;1469;380;60;440;0
9;52;control;2055;60;380;440;0
9;54;control;2140;340;180;520;0
9;55;control;1877;340;180;520;0
9;57;control;1005;240;300;540;1
9;59;multi-motive;1946;380;100;480;0
9;60;multi-motive;1474;280;280;560;1
9;61;control;1831;360;120;480;0
9;62;control;982;160;360;520;1
9;63;control;1299;380;40;420;0
9;64;control;1638;380;20;400;0
9;65;control;1342;40;380;420;1
9;66;control;1801;240;300;540;1
9;67;control;1871;360;160;520;0
9;68;control;1696;380;40;420;0
9;69;control;945;100;380;480;1
9;70;multi-motive;1885;380;40;420;0
9;71;multi-motive;1486;340;180;520;0
9;72;multi-motive;1816;100;380;480;1
9;73;control;2534;380;60;440;0
9;74;control;872;100;380;480;1
9;75;control;1373;380;60;440;0
9;76;multi-motive;2379;320;220;540;0
9;77;multi-motive;1455;280;280;560;1
9;78;multi-motive;1972;240;300;540;1
9;79;multi-motive;1501;380;40;420;0
9;80;multi-motive;2080;160;360;520;1
9;81;multi-motive;2335;360;160;520;0
9;82;multi-motive;1345;360;160;520;0
9;83;multi-motive;903;20;380;400;1
9;84;multi-motive;1268;300;240;540;0
10;1;multi-motive;1510;120;360;480;1
10;3;multi-motive;2604;340;180;520;0
10;4;multi-motive;981;60;380;440;1
10;5;multi-motive;1054;160;360;520;1
10;6;multi-motive;2315;380;40;420;0
10;7;multi-motive;1643;380;100;480;1
10;8;multi-motive;2224;360;120;480;1
10;9;multi-motive;2509;380;60;440;0
10;11;control;1165;300;240;540;1
10;12;control;968;240;300;540;1
10;13;control;1378;340;180;520;1
10;14;control;1854;20;380;400;1
10;16;control;1888;360;120;480;0
10;17;control;1492;100;380;480;1
10;18;control;1110;280;280;560;1
10;19;multi-motive;920;280;280;560;1
10;20;multi-motive;1667;360;160;520;1
10;21;multi-motive;1971;300;240;540;1
10;22;control;2654;360;120;480;0
10;23;control;2390;380;20;400;0
10;24;control;3696;380;100;480;0
10;25;control;969;120;360;480;1
10;26;control;1062;280;280;560;1
10;27;control;889;20;380;400;1
10;28;control;984;160;360;520;1
10;29;control;2343;380;20;400;0
10;30;control;3027;360;160;520;1
10;31;multi-motive;1313;280;280;560;1
10;32;multi-motive;1294;40;380;420;1
10;33;multi-motive;990;180;340;520;1
10;34;control;855;180;340;520;1
10;35;control;701;60;380;440;1
10;36;control;2521;380;40;420;0
10;37;control;1289;300;240;540;1
10;38;control;829;40;380;420;1
10;39;control;740;160;360;520;1
10;40;multi-motive;2295;240;300;540;1
10;41;multi-motive;1997;100;380;480;1
10;42;multi-motive;2714;380;60;440;0
10;43;control;3538;380;60;440;1
10;45;control;1805;380;100;480;0
10;46;control;2039;120;360;480;1
10;47;control;3380;380;60;440;1
10;48;control;1151;100;380;480;1
10;49;multi-motive;907;20;380;400;1
10;50;multi-motive;3078;320;220;540;1
10;51;multi-motive;2882;380;100;480;0
10;52;control;878;220;320;540;1
10;53;control;817;60;380;440;1
10;54;control;865;180;340;520;1
10;56;control;1955;340;180;520;1
10;57;control;2950;240;300;540;1
10;58;multi-motive;2429;360;120;480;0
10;59;multi-motive;804;340;180;520;1
10;60;multi-motive;873;20;380;400;1
10;61;multi-motive;1141;160;360;520;1
10;62;multi-motive;876;240;300;540;1
10;63;multi-motive;836;40;380;420;1
10;64;multi-motive;988;120;360;480;1
10;65;multi-motive;813;300;240;540;1
10;66;multi-motive;981;220;320;540;1
10;68;multi-motive;1981;380;20;400;0
10;70;control;993;220;320;540;1
10;71;control;1007;40;380;420;1
10;72;control;580;320;220;540;1
10;74;multi-motive;2217;380;40;420;0
10;75;multi-motive;1671;320;220;540;1
10;76;multi-motive;642;60;380;440;1
10;77;multi-motive;864;100;380;480;1
10;78;multi-motive;756;220;320;540;1
10;79;multi-motive;2659;380;20;400;0
10;80;multi-motive;974;360;160;520;1
10;81;multi-motive;886;180;340;520;1
10;82;control;1121;320;220;540;1
10;83;control;2307;380;40;420;0
10;84;control;1226;360;160;520;1
11;1;control;1065;40;380;420;1
11;2;control;1124;40;380;420;1
11;3;control;1098;220;320;540;1
11;4;control;2050;380;20;400;0
11;5;control;1297;240;300;540;1
11;6;control;1097;160;360;520;1
11;7;multi-motive;1445;340;180;520;1
11;8;multi-motive;1337;360;160;520;1
11;9;multi-motive;2911;280;280;560;0
11;10;control;2229;220;320;540;1
11;11;control;2429;380;40;420;0
11;12;control;1630;100;380;480;1
11;14;multi-motive;1774;340;180;520;1
11;15;multi-motive;2843;380;20;400;0
11;16;control;1246;180;340;520;1
11;17;control;998;300;240;540;1
11;18;control;1720;380;100;480;1
11;19;multi-motive;984;320;220;540;1
11;21;multi-motive;1692;20;380;400;1
11;22;control;2959;340;180;520;1
11;23;control;2232;240;300;540;1
11;25;multi-motive;1118;360;120;480;1
11;26;multi-motive;1397;380;100;480;1
11;27;multi-motive;1657;20;380;400;1
11;28;control;2130;300;240;540;1
11;29;control;988;20;380;400;1
11;30;control;2716;380;60;440;0
11;31;control;1068;100;380;480;1
11;32;control;1020;380;60;440;1
11;33;control;783;60;380;440;1
11;34;control;3307;360;120;480;0
11;35;control;1393;120;360;480;1
11;36;control;2868;380;20;400;0
11;37;multi-motive;901;120;360;480;1
11;38;multi-motive;1786;380;60;440;1
11;39;multi-motive;1141;40;380;420;1
11;40;multi-motive;1409;60;380;440;1
11;41;multi-motive;3625;380;60;440;0
11;42;multi-motive;865;160;360;520;1
11;43;multi-motive;918;180;340;520;1
11;44;multi-motive;2875;360;120;480;1
11;45;multi-motive;2762;380;100;480;1
11;46;multi-motive;1321;220;320;540;1
11;47;multi-motive;1084;280;280;560;1
11;48;multi-motive;1021;120;360;480;1
11;49;multi-motive;1801;60;380;440;1
11;50;multi-motive;1203;320;220;540;1
11;51;multi-motive;1156;100;380;480;1
11;52;control;2641;180;340;520;0
11;53;control;1514;120;360;480;1
11;54;control;1913;360;160;520;1
11;55;control;1617;380;40;420;1
11;56;control;2428;360;160;520;1
11;57;control;1411;280;280;560;1
11;58;multi-motive;2670;360;160;520;1
11;60;multi-motive;1517;380;40;420;1
11;61;control;1684;360;120;480;1
11;63;control;922;20;380;400;1
11;64;multi-motive;2342;380;40;420;0
11;66;multi-motive;2332;380;20;400;0
11;67;control;2099;380;100;480;1
11;68;control;1222;160;360;520;1
11;69;control;1267;280;280;560;1
11;70;multi-motive;1363;240;300;540;1
11;71;multi-motive;993;100;380;480;1
11;72;multi-motive;920;240;300;540;1
11;73;multi-motive;1105;160;360;520;1
11;74;multi-motive;1238;40;380;420;1
11;75;multi-motive;1592;180;340;520;1
11;76;control;1778;60;380;440;1
11;77;control;1508;320;220;540;1
11;78;control;1898;320;220;540;1
11;79;control;1885;340;180;520;1
11;82;multi-motive;783;300;240;540;1
11;83;multi-motive;1042;300;240;540;1
11;84;multi-motive;808;220;320;540;1
12;1;reciprocity;2311;380;60;440;0
12;2;reciprocity;1487;280;280;560;0
12;3;reciprocity;1367;60;380;440;0
12;4;reciprocity;2009;380;40;420;0
12;5;reciprocity;1472;160;360;520;1
12;6;reciprocity;1408;340;180;520;0
12;7;empathy;1520;320;220;540;1
12;9;empathy;1365;380;40;420;0
12;10;empathy;1292;340;180;520;0
12;11;empathy;1140;240;300;540;0
12;12;empathy;1719;380;40;420;1
12;13;empathy;1813;280;280;560;1
12;14;empathy;2290;100;380;480;1
12;15;empathy;3022;20;380;400;1
12;16;empathy;1953;120;360;480;1
12;17;empathy;1901;380;20;400;0
12;18;empathy;1922;300;240;540;1
12;19;reciprocity;1862;100;380;480;1
12;20;reciprocity;1714;20;380;400;1
12;21;reciprocity;1627;360;120;480;0
12;22;empathy;1753;60;380;440;1
12;23;empathy;1255;320;220;540;0
12;24;empathy;2245;240;300;540;1
12;25;reciprocity;2242;40;380;420;1
12;26;reciprocity;1488;380;100;480;0
12;27;reciprocity;2206;240;300;540;1
12;28;empathy;1500;380;60;440;0
12;29;empathy;1430;380;20;400;0
12;30;empathy;814;360;160;520;0
12;31;empathy;1347;220;320;540;1
12;33;empathy;1765;160;360;520;1
12;34;empathy;1280;380;60;440;0
12;35;empathy;1567;380;100;480;0
12;36;empathy;1413;300;240;540;0
12;37;reciprocity;2394;360;120;480;0
12;39;reciprocity;2427;120;360;480;0
12;40;reciprocity;1983;240;300;540;1
12;41;reciprocity;2707;160;360;520;0
12;42;reciprocity;1795;40;380;420;1
12;43;empathy;1160;360;120;480;0
12;44;empathy;1307;360;160;520;0
12;45;empathy;1658;180;340;520;1
12;46;empathy;1974;280;280;560;0
12;48;empathy;1235;380;100;480;0
12;49;empathy;1524;20;380;400;1
12;50;empathy;1949;180;340;520;0
12;51;empathy;1330;100;380;480;1
12;52;reciprocity;1381;320;220;540;0
12;53;reciprocity;1473;120;360;480;1
12;54;reciprocity;1860;320;220;540;0
12;55;empathy;2234;40;380;420;1
12;56;empathy;1598;60;380;440;1
12;57;empathy;1099;40;380;420;1
12;58;reciprocity;1517;380;60;440;0
12;59;reciprocity;939;340;180;520;0
12;60;reciprocity;1227;60;380;440;1
12;62;empathy;2233;340;180;520;0
12;63;empathy;1648;360;120;480;1
12;65;reciprocity;1875;100;380;480;1
12;66;reciprocity;1672;360;160;520;0
12;67;reciprocity;1471;180;340;520;1
12;69;reciprocity;1159;360;160;520;0
12;70;empathy;2006;160;360;520;1
12;71;empathy;1307;120;360;480;1
12;72;empathy;1312;220;320;540;0
12;73;reciprocity;2138;220;320;540;0
12;74;reciprocity;1267;300;240;540;0
12;75;reciprocity;1551;300;240;540;1
12;77;reciprocity;1203;380;20;400;0
12;78;reciprocity;1337;20;380;400;1
12;79;reciprocity;1310;380;40;420;0
12;80;reciprocity;2078;380;100;480;0
12;81;reciprocity;1513;280;280;560;1
12;82;reciprocity;1266;220;320;540;1
12;83;reciprocity;1835;180;340;520;1
12;84;reciprocity;1806;380;20;400;0
13;3;reciprocity;2367;300;240;540;0
13;4;empathy;2153;160;360;520;1
13;5;empathy;2188;380;60;440;0
13;6;empathy;3642;120;360;480;1
13;7;reciprocity;2996;360;160;520;0
13;8;reciprocity;1709;220;320;540;1
13;9;reciprocity;2321;380;100;480;0
13;10;reciprocity;2451;360;160;520;0
13;11;reciprocity;2709;280;280;560;0
13;12;reciprocity;1889;180;340;520;1
13;13;reciprocity;3192;20;380;400;1
13;14;reciprocity;2251;320;220;540;0
13;15;reciprocity;1910;240;300;540;1
13;17;reciprocity;1752;300;240;540;0
13;19;reciprocity;1349;60;380;440;1
13;20;reciprocity;1168;20;380;400;1
13;21;reciprocity;3123;380;20;400;0
13;22;reciprocity;2372;360;120;480;1
13;23;reciprocity;3623;40;380;420;1
13;24;reciprocity;1480;380;100;480;0
13;25;empathy;1862;300;240;540;1
13;26;empathy;2908;280;280;560;0
13;27;empathy;1904;240;300;540;0
13;28;empathy;2271;380;100;480;0
13;29;empathy;2612;380;60;440;0
13;31;empathy;3790;380;40;420;0
13;32;empathy;2075;360;120;480;1
13;33;empathy;1858;340;180;520;0
13;34;empathy;3475;60;380;440;1
13;35;empathy;2518;280;280;560;1
13;36;empathy;2359;220;320;540;1
13;37;reciprocity;1608;120;360;480;1
13;38;reciprocity;3698;380;40;420;1
13;39;reciprocity;3413;100;380;480;0
13;40;reciprocity;3642;60;380;440;1
13;41;reciprocity;1206;100;380;480;1
13;42;reciprocity;1699;360;120;480;0
13;44;empathy;2387;180;340;520;0
13;45;empathy;1794;180;340;520;1
13;46;reciprocity;2582;320;220;540;1
13;47;reciprocity;1648;220;320;540;0
13;48;reciprocity;3189;160;360;520;1
13;49;empathy;2110;20;380;400;1
13;51;empathy;2209;360;120;480;0
13;53;empathy;1764;120;360;480;1
13;54;empathy;1227;240;300;540;1
13;55;empathy;1684;340;180;520;1
13;56;empathy;1916;320;220;540;0
13;57;empathy;1984;380;100;480;1
13;58;empathy;2716;380;40;420;0
13;59;empathy;2930;320;220;540;1
13;60;empathy;2385;220;320;540;0
13;61;empathy;2681;100;380;480;0
13;63;empathy;1929;360;160;520;0
13;64;empathy;2259;300;240;540;0
13;65;empathy;2571;360;160;520;1
13;66;empathy;2860;380;20;400;0
13;67;empathy;1453;20;380;400;1
13;68;empathy;2361;160;360;520;0
13;69;empathy;1939;60;380;440;1
13;70;reciprocity;2255;340;180;520;1
13;71;reciprocity;2276;180;340;520;0
13;73;empathy;2806;40;380;420;1
13;74;empathy;1101;40;380;420;1
13;75;empathy;1429;100;380;480;1
13;76;reciprocity;1879;280;280;560;1
13;77;reciprocity;2568;380;60;440;1
13;78;reciprocity;1497;120;360;480;0
13;79;reciprocity;2482;340;180;520;0
13;80;reciprocity;1724;160;360;520;1
13;81;reciprocity;1450;40;380;420;1
13;82;reciprocity;1793;380;20;400;0
13;83;reciprocity;1719;240;300;540;0
14;1;empathy;1763;240;300;540;1
14;2;empathy;1469;360;120;480;1
14;5;empathy;1250;220;320;540;1
14;6;empathy;1571;380;100;480;1
14;7;reciprocity;926;160;360;520;1
14;8;reciprocity;864;60;380;440;1
14;9;reciprocity;1101;240;300;540;1
14;11;reciprocity;1071;100;380;480;1
14;12;reciprocity;1440;360;160;520;1
14;13;reciprocity;1069;40;380;420;1
14;14;reciprocity;1201;180;340;520;1
14;15;reciprocity;1782;340;180;520;1
14;16;reciprocity;1175;20;380;400;1
14;17;reciprocity;906;360;120;480;1
14;18;reciprocity;1312;280;280;560;1
14;19;reciprocity;1333;120;360;480;1
14;20;reciprocity;1106;180;340;520;1
14;21;reciprocity;1573;380;100;480;1
14;22;reciprocity;1165;320;220;540;1
14;23;reciprocity;1212;340;180;520;1
14;25;empathy;1040;280;280;560;1
14;26;empathy;2069;300;240;540;1
14;27;empathy;1356;360;160;520;1
14;28;empathy;782;40;380;420;1
14;29;empathy;1313;380;40;420;1
14;30;empathy;972;380;60;440;1
14;31;empathy;1272;360;120;480;1
14;32;empathy;1233;380;100;480;1
14;33;empathy;852;20;380;400;1
14;34;reciprocity;922;380;60;440;1
14;35;reciprocity;976;280;280;560;1
14;36;reciprocity;742;40;380;420;1
14;37;empathy;1632;220;320;540;1
14;38;empathy;1763;60;380;440;1
14;39;empathy;921;160;360;520;1
14;40;reciprocity;821;120;360;480;1
14;41;reciprocity;920;60;380;440;1
14;42;reciprocity;1108;300;240;540;1
14;43;empathy;1830;380;20;400;1
14;44;empathy;1201;280;280;560;1
14;45;empathy;924;120;360;480;1
14;46;empathy;1009;340;180;520;1
14;47;empathy;1004;120;360;480;1
14;48;empathy;1816;320;220;540;1
14;49;reciprocity;1246;360;160;520;1
14;50;reciprocity;1101;220;320;540;1
14;51;reciprocity;1137;380;20;400;1
14;52;empathy;1319;20;380;400;1
14;54;empathy;1155;240;300;540;1
14;55;reciprocity;1028;320;220;540;1
14;56;reciprocity;1153;160;360;520;1
14;58;empathy;2038;340;180;520;1
14;59;empathy;1233;360;160;520;1
14;60;empathy;1317;180;340;520;1
14;61;reciprocity;1673;380;20;400;1
14;62;reciprocity;842;240;300;540;1
14;63;reciprocity;808;20;380;400;1
14;64;empathy;1302;380;20;400;1
14;65;empathy;983;40;380;420;1
14;67;reciprocity;1056;360;120;480;1
14;68;reciprocity;650;100;380;480;1
14;69;reciprocity;927;380;40;420;1
14;70;empathy;910;160;360;520;1
14;71;empathy;1166;380;40;420;1
14;72;empathy;1152;180;340;520;1
14;73;empathy;936;320;220;540;1
14;74;empathy;1509;60;380;440;1
14;75;empathy;899;100;380;480;1
14;76;reciprocity;1097;380;60;440;1
14;78;reciprocity;835;300;240;540;1
14;79;empathy;1014;300;240;540;1
14;80;empathy;934;100;380;480;1
14;81;empathy;1074;380;60;440;1
14;82;reciprocity;1010;380;100;480;1
14;83;reciprocity;1156;220;320;540;1
14;84;reciprocity;1160;380;40;420;1
15;1;reciprocity;1736;380;60;440;1
15;2;reciprocity;2248;340;180;520;1
15;3;reciprocity;3189;180;340;520;0
15;4;empathy;925;280;280;560;1
15;5;empathy;1959;380;40;420;1
15;6;empathy;1032;380;60;440;1
15;7;empathy;986;340;180;520;1
15;8;empathy;2168;380;100;480;1
15;9;empathy;1122;320;220;540;1
15;10;empathy;1157;100;380;480;1
15;11;empathy;872;60;380;440;1
15;13;empathy;1502;60;380;440;1
15;14;empathy;1406;360;120;480;1
15;15;empathy;2119;360;160;520;1
15;16;empathy;1571;360;120;480;1
15;17;empathy;1380;160;360;520;1
15;19;empathy;1282;240;300;540;1
15;21;empathy;1457;20;380;400;1
15;22;reciprocity;2150;240;300;540;1
15;23;reciprocity;3312;360;160;520;0
15;24;reciprocity;1851;340;180;520;0
15;25;reciprocity;2027;360;120;480;1
15;26;reciprocity;2298;380;60;440;1
15;28;empathy;2416;40;380;420;1
15;29;empathy;1113;320;220;540;1
15;30;empathy;1538;300;240;540;1
15;31;reciprocity;2114;160;360;520;0
15;32;reciprocity;3089;380;40;420;0
15;33;reciprocity;1754;300;240;540;1
15;34;empathy;3628;380;20;400;1
15;35;empathy;801;20;380;400;1
15;36;empathy;1616;380;20;400;1
15;37;reciprocity;1953;320;220;540;0
15;38;reciprocity;3038;100;380;480;0
15;40;reciprocity;1391;60;380;440;1
15;41;reciprocity;2215;40;380;420;0
15;42;reciprocity;2657;280;280;560;1
15;43;reciprocity;2306;360;120;480;0
15;44;reciprocity;2564;180;340;520;1
15;45;reciprocity;2974;380;20;400;0
15;46;empathy;1384;240;300;540;1
15;47;empathy;1412;380;40;420;1
15;48;empathy;2254;220;320;540;1
15;49;reciprocity;2385;220;320;540;0
15;51;reciprocity;1719;380;100;480;0
15;52;reciprocity;1695;40;380;420;1
15;54;reciprocity;1746;300;240;540;0
15;55;empathy;1167;360;160;520;1
15;56;empathy;1372;380;60;440;1
15;57;empathy;1258;280;280;560;1
15;58;reciprocity;2450;320;220;540;1
15;60;reciprocity;1186;20;380;400;1
15;61;reciprocity;2437;160;360;520;0
15;62;reciprocity;3689;380;100;480;1
15;63;reciprocity;918;100;380;480;1
15;64;empathy;1300;180;340;520;1
15;65;empathy;1208;380;100;480;1
15;67;reciprocity;2818;120;360;480;1
15;68;reciprocity;3534;360;160;520;1
15;69;reciprocity;2026;240;300;540;0
15;70;reciprocity;3722;60;380;440;0
15;71;reciprocity;2457;20;380;400;0
15;73;empathy;1432;100;380;480;1
15;74;empathy;1632;160;360;520;1
15;75;empathy;1478;120;360;480;1
15;76;empathy;1371;300;240;540;1
15;77;empathy;1228;120;360;480;1
15;78;empathy;1203;220;320;540;1
15;79;reciprocity;2494;280;280;560;0
15;80;reciprocity;2670;380;40;420;1
15;81;reciprocity;2117;220;320;540;1
15;82;empathy;1136;40;380;420;1
15;83;empathy;1557;340;180;520;1
15;84;empathy;1816;180;340;520;1
16;1;reciprocity;1357;360;160;520;0
16;2;reciprocity;958;20;380;400;1
16;3;reciprocity;2041;380;20;400;0
16;4;empathy;752;20;380;400;1
16;5;empathy;813;40;380;420;1
16;6;empathy;1436;340;180;520;1
16;7;reciprocity;798;160;360;520;1
16;8;reciprocity;768;180;340;520;1
16;9;reciprocity;1239;340;180;520;1
16;10;empathy;1326;320;220;540;1
16;11;empathy;1802;380;20;400;0
16;12;empathy;1254;180;340;520;1
16;14;empathy;1201;160;360;520;1
16;15;empathy;1347;300;240;540;1
16;16;reciprocity;1797;380;40;420;1
16;17;reciprocity;2165;360;120;480;1
16;18;reciprocity;1231;280;280;560;1
16;19;empathy;1029;320;220;540;1
16;20;empathy;1959;380;40;420;0
16;21;empathy;997;280;280;560;1
16;22;reciprocity;1839;380;100;480;0
16;24;reciprocity;1218;220;320;540;1
16;25;reciprocity;1429;60;380;440;1
16;26;reciprocity;1749;40;380;420;1
16;28;empathy;1150;360;160;520;1
16;29;empathy;1610;380;100;480;1
16;30;empathy;1557;360;120;480;1
16;31;empathy;1152;240;300;540;1
16;32;empathy;1518;380;20;400;1
16;33;empathy;1196;220;320;540;1
16;34;reciprocity;1560;120;360;480;1
16;35;reciprocity;807;40;380;420;1
16;36;reciprocity;1550;360;160;520;1
16;38;empathy;1116;220;320;540;1
16;39;empathy;1054;100;380;480;1
16;40;empathy;1195;180;340;520;1
16;41;empathy;1871;380;60;440;1
16;42;empathy;921;160;360;520;1
16;43;reciprocity;1396;320;220;540;1
16;44;reciprocity;1875;240;300;540;1
16;45;reciprocity;1545;280;280;560;1
16;46;reciprocity;1364;180;340;520;1
16;47;reciprocity;816;120;360;480;1
16;48;reciprocity;921;20;380;400;1
16;49;empathy;985;340;180;520;1
16;50;empathy;747;120;360;480;1
16;51;empathy;918;380;100;480;1
16;52;reciprocity;1123;380;40;420;0
16;53;reciprocity;1430;380;60;440;1
16;54;reciprocity;1227;160;360;520;1
16;55;empathy;1320;280;280;560;1
16;56;empathy;1106;60;380;440;1
16;58;empathy;1871;40;380;420;1
16;59;empathy;1165;380;40;420;0
16;60;empathy;1482;240;300;540;0
16;61;empathy;1001;120;360;480;1
16;62;empathy;1789;60;380;440;1
16;64;empathy;1000;20;380;400;1
16;65;empathy;2279;300;240;540;1
16;66;empathy;851;380;60;440;0
16;68;reciprocity;1168;320;220;540;1
16;69;reciprocity;704;60;380;440;1
16;70;reciprocity;1468;360;120;480;1
16;71;reciprocity;910;380;100;480;1
16;72;reciprocity;1278;300;240;540;1
16;73;reciprocity;1265;300;240;540;1
16;74;reciprocity;753;100;380;480;1
16;76;reciprocity;1730;220;320;540;1
16;77;reciprocity;793;100;380;480;1
16;78;reciprocity;1887;240;300;540;1
16;79;reciprocity;1805;340;180;520;1
16;80;reciprocity;1253;380;60;440;1
16;81;reciprocity;1511;380;20;400;1
16;82;empathy;778;100;380;480;1
16;84;empathy;2562;360;160;520;1
17;1;multi-motive;1637;100;380;480;1
17;2;multi-motive;2777;360;120;480;1
17;3;multi-motive;2332;320;220;540;1
17;4;multi-motive;2584;380;40;420;1
17;5;multi-motive;1347;100;380;480;1
17;6;multi-motive;2584;380;60;440;0
17;7;control;1715;360;120;480;1
17;8;control;1355;220;320;540;1
17;9;control;3052;160;360;520;0
17;11;control;2880;60;380;440;1
17;12;control;2204;320;220;540;1
17;13;multi-motive;1414;180;340;520;1
17;14;multi-motive;1604;120;360;480;1
17;15;multi-motive;2371;120;360;480;1
17;17;control;2914;360;120;480;0
17;18;control;1315;300;240;540;1
17;19;multi-motive;1416;300;240;540;1
17;21;multi-motive;1986;220;320;540;1
17;22;multi-motive;1887;240;300;540;1
17;23;multi-motive;2399;340;180;520;1
17;24;multi-motive;2118;340;180;520;1
17;25;control;2957;180;340;520;1
17;26;control;2695;340;180;520;0
17;27;control;1724;380;60;440;1
17;28;control;1765;380;100;480;1
17;29;control;2592;380;20;400;0
17;30;control;3045;300;240;540;1
17;31;multi-motive;1626;40;380;420;1
17;32;multi-motive;1440;360;160;520;1
17;33;multi-motive;1446;280;280;560;1
17;34;control;1699;240;300;540;1
17;35;control;1623;100;380;480;1
17;36;control;2905;380;60;440;0
17;37;control;2350;220;320;540;1
17;38;control;2525;360;160;520;1
17;39;control;3136;380;40;420;0
17;40;multi-motive;1506;380;100;480;1
17;42;multi-motive;1385;60;380;440;1
17;43;multi-motive;1639;20;380;400;1
17;44;multi-motive;1907;160;360;520;1
17;46;control;1607;360;160;520;1
17;47;control;1149;160;360;520;1
17;48;control;1894;100;380;480;0
17;49;control;2189;380;20;400;0
17;50;control;1388;40;380;420;1
17;51;control;1854;240;300;540;1
17;52;multi-motive;1047;40;380;420;1
17;53;multi-motive;1993;380;40;420;1
17;54;multi-motive;1398;380;20;400;1
17;55;multi-motive;1603;160;360;520;1
17;56;multi-motive;2276;360;120;480;1
17;57;multi-motive;1669;380;20;400;1
17;58;multi-motive;1383;180;340;520;1
17;59;multi-motive;2537;380;60;440;1
17;60;multi-motive;1850;380;100;480;1
17;61;control;1132;60;380;440;1
17;63;control;1456;180;340;520;1
17;64;control;1883;20;380;400;1
17;65;control;1548;380;40;420;1
17;66;control;2937;280;280;560;0
17;67;multi-motive;1306;320;220;540;1
17;68;multi-motive;1114;20;380;400;1
17;69;multi-motive;1526;240;300;540;1
17;70;control;1849;20;380;400;1
17;71;control;1336;120;360;480;1
17;72;control;2826;120;360;480;1
17;73;control;1475;280;280;560;1
17;74;control;3076;40;380;420;1
17;76;control;1406;340;180;520;1
17;77;control;2271;380;100;480;0
17;78;control;1111;320;220;540;1
17;79;multi-motive;1592;360;160;520;1
17;80;multi-motive;1390;280;280;560;1
17;81;multi-motive;1450;220;320;540;1
17;82;multi-motive;1560;300;240;540;1
18;1;multi-motive;1088;340;180;520;1
18;2;multi-motive;563;40;380;420;1
18;3;multi-motive;623;240;300;540;1
18;4;multi-motive;934;300;240;540;1
18;5;multi-motive;601;100;380;480;1
18;6;multi-motive;802;160;360;520;1
18;7;control;1191;380;40;420;0
18;8;control;1347;160;360;520;1
18;9;control;712;60;380;440;1
18;10;multi-motive;929;380;100;480;0
18;12;multi-motive;653;120;360;480;1
18;13;multi-motive;737;380;60;440;0
18;14;multi-motive;578;60;380;440;1
18;15;multi-motive;946;280;280;560;1
18;16;multi-motive;825;320;220;540;1
18;17;multi-motive;1104;380;20;400;0
18;18;multi-motive;1056;380;100;480;0
18;19;multi-motive;1022;220;320;540;1
18;20;multi-motive;650;220;320;540;1
18;21;multi-motive;821;380;20;400;0
18;22;control;624;20;380;400;1
18;23;control;869;120;360;480;1
18;24;control;895;380;100;480;0
18;25;control;1806;100;380;480;1
18;27;control;1036;380;20;400;0
18;28;control;820;380;20;400;0
18;29;control;723;100;380;480;1
18;31;control;693;380;40;420;0
18;33;control;1505;340;180;520;0
18;34;control;1685;240;300;540;0
18;35;control;1235;40;380;420;1
18;36;control;1247;20;380;400;1
18;37;multi-motive;901;120;360;480;1
18;38;multi-motive;1304;380;40;420;0
18;39;multi-motive;1075;380;40;420;0
18;41;control;1511;120;360;480;0
18;42;control;738;360;120;480;0
18;43;multi-motive;865;20;380;400;1
18;44;multi-motive;1920;240;300;540;0
18;45;multi-motive;903;180;340;520;1
18;46;control;743;220;320;540;0
18;47;control;847;300;240;540;0
18;48;control;1222;300;240;540;0
18;49;control;1266;280;280;560;0
18;50;control;749;40;380;420;1
18;51;control;1091;220;320;540;1
18;52;control;849;360;160;520;0
18;53;control;776;320;220;540;0
18;54;control;914;240;300;540;0
18;55;multi-motive;1083;360;120;480;1
18;57;multi-motive;1029;360;120;480;1
18;58;multi-motive;1065;40;380;420;1
18;59;multi-motive;693;100;380;480;1
18;60;multi-motive;727;300;240;540;1
18;61;multi-motive;631;20;380;400;1
18;62;multi-motive;598;340;180;520;1
18;63;multi-motive;888;320;220;540;0
18;64;control;1376;360;120;480;0
18;65;control;789;380;100;480;0
18;66;control;873;360;160;520;0
18;67;control;1280;280;280;560;1
18;68;control;1122;60;380;440;1
18;69;control;1122;180;340;520;0
18;70;multi-motive;897;380;60;440;0
18;71;multi-motive;1334;360;160;520;0
18;72;multi-motive;1049;360;160;520;1
18;73;control;1170;180;340;520;1
18;74;control;907;160;360;520;1
18;75;control;959;380;60;440;0
18;76;multi-motive;586;60;380;440;1
18;77;multi-motive;569;180;340;520;1
18;78;multi-motive;1376;280;280;560;0
18;81;multi-motive;730;160;360;520;1
18;83;control;1562;340;180;520;0
18;84;control;1487;320;220;540;0
19;1;multi-motive;2068;360;160;520;1
19;2;multi-motive;838;40;380;420;1
19;3;multi-motive;2134;380;100;480;0
19;4;control;1182;20;380;400;1
19;5;control;1260;160;360;520;1
19;6;control;1891;120;360;480;1
19;7;multi-motive;1058;40;380;420;1
19;8;multi-motive;1808;380;40;420;1
19;9;multi-motive;759;60;380;440;1
19;10;multi-motive;1100;180;340;520;1
19;11;multi-motive;1719;380;20;400;1
19;14;control;1878;380;100;480;0
19;15;control;1150;240;300;540;1
19;17;multi-motive;2210;340;180;520;1
19;20;multi-motive;1273;380;60;440;1
19;21;multi-motive;1025;240;300;540;1
19;22;control;994;380;20;400;1
19;23;control;3597;340;180;520;1
19;24;control;1184;160;360;520;1
19;25;control;1900;120;360;480;1
19;26;control;887;60;380;440;1
19;27;control;3774;180;340;520;1
19;28;control;2634;100;380;480;1
19;29;control;1811;360;160;520;1
19;30;control;2054;360;120;480;1
19;31;multi-motive;1385;380;60;440;1
19;32;multi-motive;3639;340;180;520;0
19;33;multi-motive;1044;160;360;520;1
19;34;multi-motive;2725;280;280;560;0
19;35;multi-motive;1062;160;360;520;1
19;36;multi-motive;3116;300;240;540;1
19;37;multi-motive;709;220;320;540;1
19;38;multi-motive;977;220;320;540;1
19;39;multi-motive;3073;180;340;520;1
19;40;control;2571;360;120;480;0
19;42;control;2109;220;320;540;1
19;44;control;1615;280;280;560;1
19;45;control;1701;380;40;420;1
19;47;multi-motive;941;320;220;540;1
19;48;multi-motive;2185;100;380;480;0
19;50;control;1177;240;300;540;1
19;51;control;1715;340;180;520;1
19;53;control;1208;320;220;540;1
19;54;control;779;280;280;560;1
19;56;multi-motive;696;120;360;480;1
19;57;multi-motive;850;380;40;420;0
19;58;multi-motive;907;300;240;540;1
19;59;multi-motive;2513;20;380;400;0
19;60;multi-motive;929;120;360;480;1
19;61;multi-motive;881;280;280;560;1
19;62;multi-motive;881;380;20;400;1
19;63;multi-motive;2995;360;120;480;1
19;64;control;908;100;380;480;1
19;65;control;618;300;240;540;1
19;66;control;3308;380;60;440;0
19;67;control;2984;380;60;440;1
19;68;control;3234;380;100;480;1
19;69;control;2627;380;40;420;1
19;70;control;3311;60;380;440;1
19;71;control;898;40;380;420;1
19;72;control;2536;300;240;540;1
19;74;control;754;220;320;540;1
19;75;control;3790;380;20;400;1
19;76;multi-motive;985;380;100;480;1
19;77;multi-motive;744;20;380;400;1
19;80;multi-motive;1293;360;160;520;1
19;81;multi-motive;1766;320;220;540;0
19;82;control;1790;40;380;420;1
19;84;control;691;360;160;520;1
20;1;reciprocity;2373;220;320;540;1
20;2;reciprocity;3980;300;240;540;0
20;5;empathy;963;60;380;440;1
20;7;empathy;2815;40;380;420;1
20;8;empathy;1098;280;280;560;1
20;9;empathy;1655;240;300;540;0
20;10;empathy;1007;100;380;480;1
20;11;empathy;832;160;360;520;1
20;12;empathy;739;100;380;480;1
20;13;empathy;1560;380;20;400;0
20;14;empathy;748;160;360;520;1
20;15;empathy;900;380;40;420;1
20;16;empathy;1566;380;60;440;0
20;17;empathy;1648;360;120;480;0
20;18;empathy;987;380;100;480;0
20;19;reciprocity;1642;160;360;520;1
20;20;reciprocity;1747;120;360;480;1
20;21;reciprocity;1219;240;300;540;0
20;22;reciprocity;761;20;380;400;1
20;23;reciprocity;2229;120;360;480;0
20;24;reciprocity;1920;60;380;440;1
20;25;reciprocity;816;160;360;520;1
20;27;reciprocity;1021;40;380;420;1
20;28;reciprocity;2281;380;40;420;0
20;29;reciprocity;1588;360;160;520;0
20;30;reciprocity;1809;360;160;520;1
20;31;reciprocity;2049;280;280;560;0
20;32;reciprocity;899;100;380;480;1
20;33;reciprocity;2773;100;380;480;0
20;34;empathy;982;180;340;520;1
20;35;empathy;1564;340;180;520;1
20;36;empathy;2129;60;380;440;1
20;37;reciprocity;2808;320;220;540;1
20;38;reciprocity;2666;280;280;560;1
20;39;reciprocity;1778;380;100;480;0
20;41;empathy;2412;340;180;520;0
20;42;empathy;2247;360;120;480;0
20;43;empathy;1328;300;240;540;1
20;45;empathy;3970;380;40;420;0
20;46;empathy;2412;220;320;540;1
20;47;empathy;3489;120;360;480;1
20;48;empathy;1220;40;380;420;1
20;49;reciprocity;1022;360;120;480;1
20;50;reciprocity;1417;380;60;440;0
20;51;reciprocity;2164;380;40;420;0
20;52;reciprocity;3364;380;60;440;0
20;53;reciprocity;1019;320;220;540;0
20;54;reciprocity;2888;40;380;420;1
20;55;empathy;1300;20;380;400;1
20;56;empathy;1924;360;160;520;0
20;57;empathy;2425;380;20;400;1
20;58;empathy;2475;320;220;540;1
20;59;empathy;1403;380;60;440;1
20;60;empathy;1390;360;160;520;1
20;61;reciprocity;2060;220;320;540;1
20;63;reciprocity;2066;380;20;400;0
20;64;reciprocity;1881;240;300;540;1
20;65;reciprocity;1403;180;340;520;1
20;66;reciprocity;3246;180;340;520;1
20;67;reciprocity;3492;20;380;400;1
20;69;reciprocity;1949;340;180;520;0
20;70;empathy;770;240;300;540;1
20;71;empathy;1283;300;240;540;0
20;73;empathy;1638;380;100;480;0
20;74;empathy;1638;280;280;560;0
20;75;empathy;1662;320;220;540;1
20;76;reciprocity;959;300;240;540;1
20;77;reciprocity;1529;340;180;520;1
20;78;reciprocity;1343;380;20;400;0
20;79;reciprocity;1392;360;120;480;0
20;80;reciprocity;1969;380;100;480;0
20;81;reciprocity;2460;60;380;440;1
20;82;empathy;1850;180;340;520;0
20;83;empathy;1645;120;360;480;1
20;84;empathy;2058;220;320;540;1
21;1;empathy;2692;380;60;440;1
21;3;empathy;1589;280;280;560;0
21;4;reciprocity;1454;280;280;560;1
21;5;reciprocity;1463;180;340;520;1
21;6;reciprocity;2851;380;20;400;0
21;8;empathy;1856;180;340;520;0
21;9;empathy;1596;220;320;540;1
21;10;empathy;1463;60;380;440;1
21;11;empathy;1538;280;280;560;1
21;12;empathy;1694;380;20;400;1
21;13;reciprocity;1692;380;60;440;1
21;14;reciprocity;2635;340;180;520;1
21;15;reciprocity;2911;100;380;480;0
21;16;empathy;2643;20;380;400;1
21;17;empathy;1514;100;380;480;0
21;18;empathy;2477;380;100;480;1
21;20;empathy;2631;240;300;540;0
21;21;empathy;3504;120;360;480;0
21;22;empathy;1291;40;380;420;1
21;23;empathy;2679;300;240;540;1
21;24;empathy;2111;380;100;480;0
21;25;reciprocity;1643;360;160;520;0
21;26;reciprocity;1333;180;340;520;0
21;27;reciprocity;2790;120;360;480;1
21;28;reciprocity;1715;320;220;540;1
21;29;reciprocity;1538;160;360;520;0
21;30;reciprocity;3587;60;380;440;0
21;31;reciprocity;2400;240;300;540;1
21;33;reciprocity;3198;380;20;400;0
21;34;empathy;2881;380;40;420;0
21;35;empathy;1310;180;340;520;1
21;36;empathy;2947;360;160;520;0
21;37;reciprocity;1984;380;100;480;1
21;38;reciprocity;3130;220;320;540;0
21;39;reciprocity;3573;340;180;520;1
21;40;empathy;1413;320;220;540;1
21;41;empathy;2234;340;180;520;0
21;42;empathy;1673;20;380;400;1
21;43;empathy;3166;160;360;520;0
21;44;empathy;1297;240;300;540;1
21;45;empathy;3824;380;40;420;0
21;46;reciprocity;1672;360;120;480;0
21;47;reciprocity;1382;60;380;440;1
21;48;reciprocity;1104;40;380;420;1
21;49;empathy;2503;380;60;440;0
21;50;empathy;1034;100;380;480;1
21;51;empathy;3147;360;160;520;0
21;52;reciprocity;1890;380;40;420;0
21;53;reciprocity;2268;40;380;420;0
21;54;reciprocity;1182;300;240;540;1
21;55;empathy;2979;340;180;520;1
21;56;empathy;1423;360;120;480;1
21;57;empathy;2564;60;380;440;0
21;59;reciprocity;1622;240;300;540;0
21;61;empathy;3268;380;20;400;0
21;63;empathy;2219;320;220;540;0
21;64;empathy;2635;360;120;480;0
21;65;empathy;1190;300;240;540;0
21;66;empathy;1557;220;320;540;0
21;67;empathy;2037;160;360;520;1
21;68;empathy;3489;40;380;420;1
21;69;empathy;2344;120;360;480;0
21;70;reciprocity;2982;360;160;520;1
21;72;reciprocity;3026;380;40;420;0
21;73;reciprocity;1626;20;380;400;1
21;74;reciprocity;2627;380;60;440;0
21;75;reciprocity;2155;300;240;540;0
21;76;reciprocity;1363;320;220;540;0
21;77;reciprocity;1473;280;280;560;0
21;78;reciprocity;2389;120;360;480;0
21;80;reciprocity;2247;360;120;480;1
21;81;reciprocity;2391;220;320;540;1
21;82;reciprocity;1260;160;360;520;1
21;83;reciprocity;1077;380;100;480;0
21;84;reciprocity;1708;100;380;480;1
22;1;empathy;1328;120;360;480;1
22;2;empathy;1213;100;380;480;1
22;3;empathy;1387;380;40;420;0
22;4;empathy;1924;380;100;480;1
22;5;empathy;1746;380;60;440;1
22;6;empathy;1264;340;180;520;1
22;7;reciprocity;1389;240;300;540;1
22;8;reciprocity;1298;280;280;560;1
22;9;reciprocity;2338;320;220;540;1
22;11;empathy;1378;380;60;440;1
22;12;empathy;2093;180;340;520;1
22;13;reciprocity;1466;60;380;440;1
22;14;reciprocity;1810;380;60;440;0
22;15;reciprocity;1803;40;380;420;1
22;16;empathy;1447;60;380;440;1
22;17;empathy;1787;280;280;560;1
22;18;empathy;1644;320;220;540;1
22;19;empathy;1502;160;360;520;1
22;20;empathy;1687;20;380;400;1
22;21;empathy;1470;40;380;420;1
22;22;reciprocity;1803;120;360;480;1
22;24;reciprocity;1292;40;380;420;1
22;25;reciprocity;2557;360;120;480;0
22;26;reciprocity;1372;20;380;400;1
22;27;reciprocity;1398;300;240;540;1
22;28;reciprocity;2708;340;180;520;1
22;29;reciprocity;1764;240;300;540;1
22;30;reciprocity;2722;360;160;520;0
22;31;empathy;1317;120;360;480;1
22;32;empathy;1359;220;320;540;1
22;33;empathy;1329;40;380;420;1
22;34;reciprocity;1558;380;40;420;0
22;35;reciprocity;930;100;380;480;1
22;36;reciprocity;2195;300;240;540;1
22;37;empathy;1533;340;180;520;1
22;38;empathy;1482;100;380;480;1
22;39;empathy;2020;380;20;400;0
22;40;reciprocity;1433;120;360;480;1
22;41;reciprocity;1579;180;340;520;1
22;42;reciprocity;2963;320;220;540;1
22;43;reciprocity;1473;380;40;420;0
22;46;empathy;2046;320;220;540;1
22;47;empathy;1660;280;280;560;1
22;48;empathy;1404;300;240;540;1
22;49;reciprocity;1343;160;360;520;1
22;50;reciprocity;2391;360;120;480;0
22;51;reciprocity;1217;180;340;520;1
22;52;empathy;1262;240;300;540;1
22;53;empathy;1378;360;160;520;1
22;56;reciprocity;1342;220;320;540;1
22;57;reciprocity;1225;60;380;440;1
22;58;empathy;1464;220;320;540;1
22;59;empathy;2870;360;120;480;1
22;60;empathy;1394;60;380;440;1
22;61;reciprocity;2406;380;100;480;0
22;62;reciprocity;1072;20;380;400;1
22;63;reciprocity;1900;340;180;520;1
22;64;reciprocity;1665;380;20;400;1
22;65;reciprocity;1415;160;360;520;1
22;66;reciprocity;1405;280;280;560;1
22;67;empathy;1473;180;340;520;1
22;69;empathy;1851;360;160;520;1
22;70;reciprocity;1869;220;320;540;1
22;71;reciprocity;1665;380;100;480;1
22;72;reciprocity;2210;380;20;400;1
22;73;empathy;1752;240;300;540;1
22;74;empathy;2426;360;120;480;0
22;75;empathy;2256;380;20;400;0
22;76;empathy;2071;380;40;420;1
22;77;empathy;2183;160;360;520;1
22;78;empathy;1499;20;380;400;1
22;80;empathy;1592;300;240;540;1
22;81;empathy;1991;380;100;480;0
22;82;reciprocity;2712;380;60;440;1
22;83;reciprocity;1717;100;380;480;1
22;84;reciprocity;3311;360;160;520;1
23;1;multi-motive;2465;120;360;480;1
23;2;multi-motive;2583;60;380;440;1
23;3;multi-motive;2162;220;320;540;1
23;4;control;1477;380;20;400;1
23;5;control;2325;180;340;520;0
23;6;control;2739;380;100;480;0
23;7;multi-motive;2334;320;220;540;1
23;8;multi-motive;1946;380;60;440;1
23;9;multi-motive;3099;380;20;400;0
23;11;control;1867;20;380;400;1
23;12;control;1629;40;380;420;1
23;13;control;2375;380;100;480;0
23;14;control;1634;300;240;540;0
23;15;control;1297;100;380;480;1
23;16;multi-motive;1647;360;160;520;1
23;17;multi-motive;2614;240;300;540;1
23;18;multi-motive;2473;340;180;520;0
23;21;multi-motive;1430;360;120;480;1
23;22;control;1776;360;120;480;1
23;24;control;2934;240;300;540;0
23;25;control;1578;340;180;520;0
23;26;control;1715;240;300;540;0
23;27;control;3150;220;320;540;0
23;28;multi-motive;1876;300;240;540;1
23;29;multi-motive;2509;60;380;440;1
23;31;control;2284;380;40;420;0
23;32;control;1938;320;220;540;0
23;33;control;2197;60;380;440;1
23;34;control;2845;60;380;440;0
23;36;control;1104;180;340;520;1
23;37;multi-motive;2899;180;340;520;1
23;38;multi-motive;2907;180;340;520;0
23;40;control;2700;120;360;480;0
23;41;control;2105;20;380;400;1
23;42;control;2273;380;60;440;0
23;44;multi-motive;2968;340;180;520;1
23;45;multi-motive;2167;320;220;540;0
23;46;multi-motive;2697;20;380;400;1
23;47;multi-motive;2690;380;60;440;1
23;48;multi-motive;3446;220;320;540;0
23;49;control;1784;280;280;560;0
23;50;control;3071;320;220;540;0
23;51;control;3112;340;180;520;1
23;52;control;2909;120;360;480;1
23;53;control;3391;300;240;540;1
23;54;control;2955;360;160;520;0
23;55;multi-motive;2086;380;40;420;1
23;56;multi-motive;2193;20;380;400;1
23;57;multi-motive;1896;160;360;520;1
23;58;multi-motive;2803;360;160;520;1
23;59;multi-motive;2142;280;280;560;1
23;60;multi-motive;978;40;380;420;1
23;61;multi-motive;1714;280;280;560;0
23;62;multi-motive;1099;100;380;480;1
23;63;multi-motive;1772;380;20;400;1
23;64;multi-motive;1521;360;120;480;1
23;65;multi-motive;1668;380;100;480;1
23;66;multi-motive;2121;380;40;420;1
23;67;control;1902;360;160;520;1
23;68;control;2140;160;360;520;0
23;69;control;2380;40;380;420;0
23;70;multi-motive;1689;240;300;540;1
23;71;multi-motive;1360;160;360;520;1
23;72;multi-motive;1969;40;380;420;1
23;73;control;2667;160;360;520;1
23;74;control;1985;100;380;480;0
23;75;control;2327;380;60;440;1
23;76;control;1952;380;20;400;0
23;77;control;2067;280;280;560;1
23;78;control;1539;380;40;420;0
23;80;control;1953;360;120;480;0
23;81;control;1671;220;320;540;0
23;82;multi-motive;2715;100;380;480;1
23;83;multi-motive;1683;120;360;480;1
23;84;multi-motive;2639;380;100;480;1
24;1;multi-motive;1028;300;240;540;1
24;2;multi-motive;1036;380;20;400;1
24;3;multi-motive;909;100;380;480;1
24;4;multi-motive;1562;20;380;400;1
24;5;multi-motive;1211;380;100;480;1
24;6;multi-motive;1462;60;380;440;1
24;7;control;1131;380;60;440;1
24;8;control;1203;280;280;560;1
24;9;control;1180;60;380;440;1
24;11;control;1022;380;100;480;1
24;12;control;1413;340;180;520;1
24;14;control;781;360;160;520;1
24;16;multi-motive;746;120;360;480;1
24;17;multi-motive;1223;40;380;420;1
24;19;multi-motive;1077;340;180;520;1
24;20;multi-motive;1287;360;120;480;0
24;22;multi-motive;972;380;60;440;1
24;23;multi-motive;1485;340;180;520;1
24;24;multi-motive;749;40;380;420;1
24;25;control;783;180;340;520;1
24;26;control;1188;380;40;420;1
24;27;control;1220;280;280;560;1
24;28;control;1567;380;60;440;1
24;29;control;1464;100;380;480;1
24;30;control;755;60;380;440;1
24;31;multi-motive;1227;20;380;400;1
24;33;multi-motive;1512;240;300;540;0
24;34;multi-motive;1115;240;300;540;1
24;35;multi-motive;847;360;120;480;1
24;36;multi-motive;903;180;340;520;1
24;37;control;1533;40;380;420;1
24;38;control;994;360;120;480;1
24;39;control;956;220;320;540;1
24;40;multi-motive;1372;180;340;520;1
24;41;multi-motive;858;280;280;560;1
24;42;multi-motive;932;300;240;540;1
24;43;multi-motive;1114;360;160;520;0
24;44;multi-motive;948;380;60;440;1
24;45;multi-motive;1152;320;220;540;1
24;46;multi-motive;1329;380;40;420;1
24;47;multi-motive;1800;320;220;540;1
24;48;multi-motive;1872;160;360;520;0
24;49;control;934;300;240;540;1
24;50;control;1828;360;160;520;1
24;51;control;2521;380;20;400;0
24;52;control;1879;320;220;540;1
24;54;control;825;240;300;540;1
24;55;control;797;160;360;520;1
24;56;control;2054;380;40;420;1
24;57;control;2131;160;360;520;1
24;58;control;1413;100;380;480;1
24;59;control;1017;20;380;400;1
24;60;control;1422;380;100;480;1
24;61;control;1849;360;120;480;1
24;62;control;1019;180;340;520;1
24;63;control;1010;320;220;540;1
24;64;multi-motive;990;100;380;480;1
24;65;multi-motive;794;60;380;440;1
24;66;multi-motive;1646;220;320;540;0
24;67;multi-motive;1486;120;360;480;1
24;68;multi-motive;1819;280;280;560;1
24;70;control;1136;40;380;420;1
24;71;control;1553;380;20;400;1
24;74;multi-motive;868;360;160;520;1
24;75;multi-motive;1948;380;20;400;0
24;76;control;1601;300;240;540;1
24;77;control;670;20;380;400;1
24;78;control;729;120;360;480;1
24;79;multi-motive;993;160;360;520;1
24;80;multi-motive;1080;380;40;420;1
24;81;multi-motive;1200;380;100;480;1
24;82;control;960;120;360;480;1
24;83;control;1237;240;300;540;1
24;84;control;934;340;180;520;1
25;1;multi-motive;2787;360;120;480;0
25;2;multi-motive;2292;240;300;540;1
25;4;multi-motive;1183;220;320;540;1
25;5;multi-motive;3080;240;300;540;0
25;6;multi-motive;1343;380;20;400;1
25;7;control;2676;380;60;440;0
25;9;control;1736;40;380;420;0
25;10;control;2101;20;380;400;0
25;11;control;1428;100;380;480;1
25;14;multi-motive;939;100;380;480;1
25;15;multi-motive;3086;180;340;520;1
25;16;multi-motive;2391;380;20;400;0
25;18;multi-motive;2123;160;360;520;1
25;19;control;3648;360;160;520;1
25;20;control;915;20;380;400;1
25;21;control;760;60;380;440;1
25;22;control;1730;220;320;540;0
25;23;control;3210;380;100;480;1
25;24;control;3135;120;360;480;1
25;25;multi-motive;1631;320;220;540;0
25;26;multi-motive;3477;20;380;400;1
25;27;multi-motive;749;40;380;420;1
25;28;control;2721;180;340;520;1
25;29;control;2021;100;380;480;0
25;30;control;2852;380;40;420;0
25;31;multi-motive;972;20;380;400;1
25;32;multi-motive;2542;100;380;480;1
25;33;multi-motive;3054;360;120;480;1
25;34;control;2191;300;240;540;1
25;35;control;1915;280;280;560;0
25;36;control;877;40;380;420;1
25;37;control;2104;280;280;560;0
25;39;control;2539;160;360;520;0
25;40;multi-motive;1865;300;240;540;1
25;43;control;2468;340;180;520;1
25;44;control;3042;160;360;520;1
25;45;control;1726;220;320;540;1
25;46;control;1541;360;160;520;0
25;47;control;1534;380;100;480;0
25;48;control;1903;300;240;540;0
25;49;control;2779;380;40;420;1
25;51;control;1619;380;60;440;0
25;52;multi-motive;2181;280;280;560;1
25;53;multi-motive;1380;60;380;440;1
25;54;multi-motive;2132;360;160;520;1
25;55;control;3224;120;360;480;1
25;56;control;1482;320;220;540;1
25;57;control;1984;380;20;400;1
25;58;multi-motive;1895;380;60;440;0
25;59;multi-motive;2284;280;280;560;0
25;60;multi-motive;2557;180;340;520;1
25;61;control;1496;180;340;520;1
25;62;control;2201;240;300;540;0
25;63;control;2635;340;180;520;0
25;64;multi-motive;1048;120;360;480;1
25;65;multi-motive;1703;380;100;480;1
25;66;multi-motive;2378;120;360;480;1
25;67;multi-motive;3330;380;40;420;1
25;68;multi-motive;3046;40;380;420;0
25;69;multi-motive;1144;60;380;440;1
25;70;control;2905;60;380;440;0
25;71;control;2830;360;120;480;1
25;72;control;1646;240;300;540;1
25;73;control;1596;320;220;540;0
25;74;control;2223;360;120;480;0
25;75;control;2557;380;20;400;0
25;76;multi-motive;1590;380;40;420;1
25;77;multi-motive;1584;360;160;520;1
25;78;multi-motive;1945;340;180;520;1
25;80;multi-motive;1833;340;180;520;1
25;81;multi-motive;1713;160;360;520;1
25;82;multi-motive;1155;380;100;480;0
25;83;multi-motive;2437;380;60;440;0
25;84;multi-motive;1109;320;220;540;1
26;1;multi-motive;3061;60;380;440;1
26;2;multi-motive;3024;20;380;400;0
26;3;multi-motive;1745;360;120;480;0
26;4;control;2549;380;100;480;1
26;5;control;1836;100;380;480;1
26;6;control;2231;100;380;480;0
26;7;multi-motive;1751;300;240;540;1
26;8;multi-motive;1582;160;360;520;1
26;9;multi-motive;3286;340;180;520;0
26;10;control;2157;120;360;480;0
26;11;control;1220;320;220;540;1
26;12;control;1257;160;360;520;1
26;13;multi-motive;1053;240;300;540;0
26;15;multi-motive;1096;160;360;520;1
26;16;control;2466;380;60;440;1
26;18;control;1499;380;40;420;0
26;19;multi-motive;3693;360;160;520;0
26;20;multi-motive;2497;380;100;480;0
26;21;multi-motive;2026;120;360;480;0
26;22;control;1102;360;120;480;0
26;23;control;2788;220;320;540;1
26;24;control;1188;180;340;520;1
26;25;multi-motive;3048;320;220;540;1
26;26;multi-motive;3552;220;320;540;1
26;27;multi-motive;2915;180;340;520;0
26;28;control;2279;380;100;480;0
26;29;control;2815;360;120;480;1
26;30;control;1266;380;40;420;0
26;31;control;1432;240;300;540;1
26;32;control;2341;380;20;400;0
26;33;control;1515;320;220;540;0
26;34;multi-motive;2030;320;220;540;1
26;35;multi-motive;1800;380;100;480;1
26;36;multi-motive;780;60;380;440;0
26;38;multi-motive;3082;380;40;420;0
26;39;multi-motive;1278;20;380;400;1
26;41;multi-motive;1014;280;280;560;1
26;42;multi-motive;1107;180;340;520;1
26;43;control;1089;120;360;480;1
26;44;control;2443;20;380;400;0
26;45;control;1691;60;380;440;1
26;46;control;1620;280;280;560;1
26;47;control;1418;240;300;540;0
26;48;control;2616;180;340;520;1
26;49;multi-motive;2697;100;380;480;1
26;50;multi-motive;2617;240;300;540;1
26;51;multi-motive;886;100;380;480;1
26;52;control;1436;220;320;540;0
26;54;control;2379;40;380;420;0
26;55;control;2474;380;60;440;1
26;56;control;1077;360;160;520;1
26;58;control;2485;300;240;540;0
26;59;control;1303;340;180;520;0
26;60;control;1111;280;280;560;0
26;62;multi-motive;1798;300;240;540;1
26;63;multi-motive;1085;360;160;520;1
26;64;control;1669;300;240;540;1
26;66;control;827;40;380;420;1
26;67;control;144;340;180;520;0
26;68;control;1797;360;160;520;1
26;69;control;1716;60;380;440;0
26;70;control;1303;160;360;520;0
26;71;control;1029;20;380;400;1
26;72;control;3824;380;20;400;1
26;73;multi-motive;2666;280;280;560;1
26;74;multi-motive;2319;40;380;420;1
26;75;multi-motive;1585;380;60;440;1
26;77;multi-motive;1915;340;180;520;1
26;78;multi-motive;1003;120;360;480;1
26;79;multi-motive;1324;360;120;480;1
26;80;multi-motive;3710;380;20;400;1
26;81;multi-motive;1894;220;320;540;1
26;82;multi-motive;3741;380;40;420;1
26;83;multi-motive;1622;380;60;440;1
26;84;multi-motive;785;40;380;420;1
27;1;control;2466;360;120;480;1
27;2;control;1556;300;240;540;1
27;3;control;1404;240;300;540;1
27;4;multi-motive;1025;340;180;520;0
27;5;multi-motive;1998;280;280;560;0
27;6;multi-motive;2922;120;360;480;0
27;7;control;1807;120;360;480;0
27;8;control;1155;380;100;480;1
27;9;control;1080;160;360;520;1
27;10;control;1019;340;180;520;1
27;11;control;812;220;320;540;1
27;12;control;1773;220;320;540;1
27;13;control;1273;60;380;440;0
27;14;control;1324;380;20;400;1
27;15;control;1544;320;220;540;1
27;16;control;2026;340;180;520;1
27;18;control;1184;40;380;420;0
27;19;multi-motive;1432;100;380;480;1
27;20;multi-motive;1642;380;20;400;1
27;21;multi-motive;3320;240;300;540;1
27;22;multi-motive;1484;320;220;540;1
27;23;multi-motive;3709;60;380;440;1
27;24;multi-motive;1899;380;60;440;1
27;25;multi-motive;1410;380;40;420;1
27;26;multi-motive;1027;360;160;520;0
27;27;multi-motive;1494;380;20;400;1
27;28;control;2909;60;380;440;1
27;29;control;1818;320;220;540;1
27;30;control;1321;100;380;480;0
27;31;multi-motive;1262;380;60;440;1
27;32;multi-motive;835;240;300;540;1
27;33;multi-motive;2170;380;100;480;1
27;34;control;853;380;100;480;0
27;37;multi-motive;1204;60;380;440;1
27;38;multi-motive;2376;380;40;420;0
27;39;multi-motive;1822;360;160;520;1
27;40;multi-motive;1049;160;360;520;1
27;41;multi-motive;1224;220;320;540;1
27;42;multi-motive;1112;160;360;520;1
27;43;control;1466;120;360;480;1
27;44;control;1029;100;380;480;1
27;45;control;1002;40;380;420;1
27;46;control;1209;20;380;400;0
27;47;control;2225;280;280;560;1
27;48;control;1587;380;40;420;0
27;49;multi-motive;1015;20;380;400;1
27;51;multi-motive;815;120;360;480;1
27;52;multi-motive;1654;360;120;480;1
27;54;multi-motive;978;100;380;480;1
27;55;control;1324;300;240;540;0
27;56;control;1188;360;120;480;1
27;57;control;909;380;60;440;1
27;59;multi-motive;1929;180;340;520;1
27;60;multi-motive;1206;280;280;560;1
27;61;control;1285;240;300;540;0
27;62;control;1171;160;360;520;0
27;63;control;1102;360;160;520;1
27;64;multi-motive;1605;180;340;520;1
27;65;multi-motive;1464;40;380;420;1
27;66;multi-motive;961;320;220;540;1
27;69;control;1056;180;340;520;1
27;70;multi-motive;1110;360;120;480;1
27;71;multi-motive;2360;380;100;480;0
27;73;control;1304;180;340;520;1
27;74;control;2685;380;40;420;0
27;75;control;1198;280;280;560;1
27;76;control;3165;380;60;440;0
27;77;control;1423;20;380;400;1
27;78;control;1453;380;20;400;1
27;79;multi-motive;884;220;320;540;1
27;80;multi-motive;1018;40;380;420;1
27;81;multi-motive;2939;20;380;400;1
27;82;multi-motive;1887;300;240;540;0
27;83;multi-motive;991;300;240;540;1
27;84;multi-motive;731;340;180;520;1
28;1;control;1398;60;380;440;0
28;3;control;1255;360;160;520;0
28;5;multi-motive;719;180;340;520;1
28;6;multi-motive;1088;220;320;540;1
28;7;multi-motive;879;340;180;520;1
28;8;multi-motive;1789;360;120;480;1
28;9;multi-motive;805;300;240;540;1
28;10;multi-motive;669;40;380;420;1
28;11;multi-motive;721;320;220;540;1
28;12;multi-motive;1093;20;380;400;1
28;13;control;739;380;20;400;0
28;14;control;1083;240;300;540;0
28;15;control;1191;220;320;540;0
28;16;multi-motive;889;380;40;420;1
28;17;multi-motive;895;60;380;440;1
28;18;multi-motive;647;20;380;400;1
28;19;control;1724;280;280;560;0
28;20;control;717;120;360;480;1
28;21;control;1602;40;380;420;0
28;22;multi-motive;940;280;280;560;1
28;24;multi-motive;751;40;380;420;1
28;25;multi-motive;796;100;380;480;1
28;26;multi-motive;779;120;360;480;1
28;27;multi-motive;745;380;20;400;1
28;29;control;1237;380;100;480;0
28;30;control;2497;300;240;540;1
28;31;control;1100;120;360;480;0
28;32;control;959;280;280;560;0
28;33;control;1263;380;60;440;0
28;35;multi-motive;1453;380;20;400;1
28;36;multi-motive;1609;380;100;480;1
28;37;control;2110;180;340;520;1
28;38;control;2567;100;380;480;1
28;39;control;1007;360;120;480;0
28;40;control;1051;380;40;420;0
28;41;control;1374;340;180;520;0
28;42;control;3289;240;300;540;1
28;43;control;852;360;160;520;0
28;44;control;984;300;240;540;0
28;45;control;1099;380;40;420;0
28;46;control;906;100;380;480;0
28;47;control;1305;160;360;520;0
28;48;control;1237;40;380;420;0
28;49;multi-motive;912;360;120;480;1
28;50;multi-motive;828;180;340;520;1
28;51;multi-motive;811;220;320;540;1
28;52;control;1247;360;120;480;0
28;53;control;844;320;220;540;0
28;54;control;849;320;220;540;0
28;55;multi-motive;1227;380;40;420;1
28;56;multi-motive;804;280;280;560;1
28;57;multi-motive;1273;380;60;440;1
28;59;multi-motive;783;300;240;540;1
28;60;multi-motive;836;160;360;520;1
28;61;control;1109;340;180;520;0
28;62;control;876;380;100;480;0
28;63;control;917;380;60;440;0
28;64;multi-motive;1625;340;180;520;1
28;65;multi-motive;1126;380;60;440;1
28;66;multi-motive;981;120;360;480;1
28;67;multi-motive;767;160;360;520;1
28;68;multi-motive;1428;360;160;520;1
28;69;multi-motive;755;360;160;520;1
28;70;control;942;60;380;440;0
28;71;control;997;20;380;400;0
28;72;control;1192;160;360;520;0
28;73;multi-motive;912;380;100;480;1
28;74;multi-motive;877;240;300;540;1
28;75;multi-motive;757;240;300;540;1
28;76;control;1025;180;340;520;0
28;78;control;1656;380;20;400;0
28;79;control;1019;220;320;540;0
28;80;control;2834;20;380;400;1
28;82;multi-motive;733;320;220;540;1
28;83;multi-motive;1140;100;380;480;1
28;84;multi-motive;893;60;380;440;1
29;1;control;1329;20;380;400;1
29;2;control;2026;380;20;400;0
29;3;control;3175;380;60;440;1
29;5;multi-motive;1982;300;240;540;1
29;6;multi-motive;1822;240;300;540;1
29;7;control;2087;360;120;480;1
29;8;control;1751;300;240;540;1
29;9;control;1525;20;380;400;1
29;10;multi-motive;863;20;380;400;1
29;11;multi-motive;887;60;380;440;1
29;12;multi-motive;931;320;220;540;1
29;13;control;1508;180;340;520;1
29;14;control;1480;280;280;560;1
29;15;control;1000;180;340;520;1
29;16;control;1281;60;380;440;1
29;17;control;2534;380;40;420;0
29;18;control;836;240;300;540;1
29;19;control;1294;220;320;540;1
29;21;control;900;60;380;440;1
29;22;multi-motive;1486;300;240;540;1
29;23;multi-motive;1388;380;40;420;1
29;24;multi-motive;1136;160;360;520;1
29;25;control;2254;320;220;540;1
29;27;control;2074;340;180;520;1
29;28;multi-motive;882;360;120;480;1
29;29;multi-motive;1132;360;120;480;1
29;30;multi-motive;1215;220;320;540;1
29;31;multi-motive;1183;240;300;540;1
29;32;multi-motive;1605;120;360;480;1
29;33;multi-motive;2248;380;60;440;1
29;34;control;1929;100;380;480;1
29;35;control;3113;380;40;420;0
29;36;control;1450;160;360;520;1
29;37;control;1432;220;320;540;1
29;38;control;1864;100;380;480;1
29;39;control;1012;320;220;540;1
29;40;multi-motive;1404;100;380;480;1
29;42;multi-motive;1272;220;320;540;1
29;43;multi-motive;1045;180;340;520;1
29;44;multi-motive;983;280;280;560;1
29;45;multi-motive;939;180;340;520;1
29;47;control;2320;340;180;520;1
29;49;control;1141;120;360;480;1
29;50;control;1938;280;280;560;1
29;51;control;3044;380;100;480;1
29;52;control;1128;40;380;420;1
29;53;control;1737;300;240;540;1
29;54;control;2822;360;160;520;1
29;55;control;1118;40;380;420;1
29;56;control;2304;360;120;480;1
29;57;control;2390;360;160;520;1
29;58;multi-motive;1520;380;100;480;1
29;59;multi-motive;1640;40;380;420;1
29;60;multi-motive;1805;340;180;520;1
29;61;multi-motive;1559;380;20;400;1
29;62;multi-motive;2085;380;20;400;0
29;63;multi-motive;2875;380;60;440;1
29;64;control;1729;380;100;480;1
29;65;control;1712;380;20;400;0
29;66;control;2164;120;360;480;1
29;67;control;1408;160;360;520;1
29;68;control;1648;240;300;540;1
29;71;multi-motive;1863;280;280;560;1
29;72;multi-motive;1293;20;380;400;1
29;73;multi-motive;3074;380;40;420;1
29;74;multi-motive;1972;320;220;540;1
29;76;multi-motive;929;120;360;480;1
29;77;multi-motive;1657;100;380;480;1
29;78;multi-motive;1910;340;180;520;1
29;79;multi-motive;1468;360;160;520;1
29;80;multi-motive;1067;60;380;440;1
29;81;multi-motive;1895;40;380;420;1
29;82;multi-motive;956;160;360;520;1
29;83;multi-motive;1809;380;100;480;1
29;84;multi-motive;2125;360;160;520;1
30;1;control;1151;180;340;520;1
30;2;control;778;160;360;520;1
30;4;control;669;120;360;480;1
30;6;control;993;60;380;440;1
30;7;control;816;360;160;520;1
30;8;control;1247;280;280;560;1
30;9;control;1494;380;40;420;1
30;10;control;1044;320;220;540;1
30;11;control;775;20;380;400;1
30;12;control;1052;100;380;480;1
30;13;multi-motive;839;180;340;520;1
30;14;multi-motive;992;40;380;420;1
30;15;multi-motive;1099;380;100;480;1
30;16;control;869;240;300;540;1
30;17;control;1166;380;100;480;1
30;18;control;1014;240;300;540;1
30;19;control;994;300;240;540;1
30;20;control;722;220;320;540;1
30;21;control;995;340;180;520;1
30;22;multi-motive;973;300;240;540;1
30;24;multi-motive;983;160;360;520;1
30;25;control;1064;380;100;480;1
30;26;control;1161;380;40;420;1
30;27;control;1307;60;380;440;1
30;28;control;1398;40;380;420;1
30;29;control;1180;40;380;420;1
30;31;multi-motive;1214;240;300;540;1
30;32;multi-motive;1294;380;40;420;1
30;33;multi-motive;1945;280;280;560;1
30;34;multi-motive;1145;360;120;480;1
30;36;multi-motive;2696;380;60;440;1
30;37;multi-motive;2730;380;40;420;1
30;38;multi-motive;1090;220;320;540;1
30;39;multi-motive;1232;120;360;480;1
30;40;control;917;320;220;540;1
30;41;control;1631;380;20;400;1
30;43;multi-motive;1548;280;280;560;1
30;44;multi-motive;1471;380;20;400;1
30;45;multi-motive;1209;100;380;480;1
30;46;multi-motive;1191;100;380;480;1
30;47;multi-motive;1017;320;220;540;1
30;48;multi-motive;1421;20;380;400;1
30;49;multi-motive;1012;60;380;440;1
30;51;multi-motive;884;380;100;480;1
30;52;control;775;20;380;400;1
30;53;control;817;340;180;520;1
30;54;control;821;220;320;540;1
30;55;multi-motive;832;340;180;520;1
30;56;multi-motive;710;40;380;420;1
30;57;multi-motive;839;220;320;540;1
30;58;multi-motive;872;180;340;520;1
30;60;multi-motive;839;20;380;400;1
30;61;multi-motive;1627;340;180;520;1
30;62;multi-motive;1144;360;160;520;1
30;63;multi-motive;886;360;160;520;1
30;64;control;965;360;120;480;1
30;65;control;886;360;120;480;1
30;66;control;853;180;340;520;1
30;67;multi-motive;1007;320;220;540;1
30;68;multi-motive;839;240;300;540;1
30;69;multi-motive;1449;360;120;480;1
30;70;control;945;380;60;440;1
30;71;control;858;380;60;440;1
30;72;control;831;280;280;560;1
30;73;multi-motive;1012;300;240;540;1
30;74;multi-motive;855;380;60;440;1
30;75;multi-motive;970;120;360;480;1
30;76;control;880;160;360;520;1
30;77;control;977;360;160;520;1
30;79;multi-motive;892;160;360;520;1
30;80;multi-motive;825;60;380;440;1
30;81;multi-motive;982;380;20;400;1
30;82;control;923;300;240;540;1
30;83;control;782;100;380;480;1
30;84;control;1214;120;360;480;1
31;1;reciprocity;1320;380;20;400;1
31;3;reciprocity;1512;60;380;440;0
31;4;empathy;1182;280;280;560;1
31;5;empathy;1081;360;160;520;1
31;6;empathy;1331;280;280;560;1
31;7;empathy;890;380;60;440;1
31;8;empathy;1269;320;220;540;1
31;9;empathy;1101;20;380;400;1
31;10;empathy;773;160;360;520;1
31;11;empathy;973;320;220;540;1
31;13;empathy;1003;100;380;480;1
31;14;empathy;733;60;380;440;1
31;16;reciprocity;1675;380;40;420;1
31;18;reciprocity;1043;180;340;520;0
31;20;reciprocity;1283;120;360;480;1
31;21;reciprocity;839;20;380;400;1
31;22;reciprocity;1430;160;360;520;1
31;23;reciprocity;1476;340;180;520;1
31;24;reciprocity;1568;380;20;400;0
31;25;empathy;803;300;240;540;1
31;26;empathy;1455;60;380;440;1
31;27;empathy;2042;380;40;420;0
31;28;empathy;1546;380;20;400;1
31;29;empathy;867;40;380;420;1
31;30;empathy;788;360;120;480;1
31;31;empathy;989;220;320;540;1
31;32;empathy;1338;380;40;420;1
31;33;empathy;1352;380;20;400;1
31;34;reciprocity;2552;380;100;480;1
31;35;reciprocity;867;60;380;440;1
31;36;reciprocity;1465;360;160;520;0
31;37;empathy;1024;100;380;480;1
31;38;empathy;1369;40;380;420;1
31;39;empathy;1061;360;120;480;1
31;41;reciprocity;630;40;380;420;1
31;42;reciprocity;1507;100;380;480;1
31;43;reciprocity;1063;320;220;540;1
31;44;reciprocity;797;40;380;420;1
31;45;reciprocity;1073;240;300;540;1
31;46;reciprocity;1145;340;180;520;0
31;47;reciprocity;1143;280;280;560;1
31;48;reciprocity;1574;360;120;480;1
31;49;reciprocity;1884;280;280;560;1
31;50;reciprocity;1366;300;240;540;1
31;51;reciprocity;784;100;380;480;1
31;52;reciprocity;2055;380;60;440;1
31;53;reciprocity;1230;180;340;520;1
31;54;reciprocity;1728;360;120;480;1
31;55;empathy;889;220;320;540;1
31;56;empathy;1530;340;180;520;1
31;58;reciprocity;1340;380;40;420;0
31;59;reciprocity;1972;360;160;520;1
31;60;reciprocity;1328;380;100;480;0
31;61;empathy;590;180;340;520;1
31;62;empathy;923;240;300;540;1
31;63;empathy;1504;120;360;480;1
31;64;empathy;3655;20;380;400;1
31;65;empathy;1115;380;60;440;1
31;66;empathy;1017;120;360;480;1
31;67;empathy;1601;380;100;480;1
31;68;empathy;1001;340;180;520;1
31;70;reciprocity;1093;300;240;540;1
31;71;reciprocity;1497;220;320;540;1
31;72;reciprocity;1949;220;320;540;0
31;74;empathy;905;360;160;520;1
31;75;empathy;786;180;340;520;1
31;76;reciprocity;931;120;360;480;1
31;77;reciprocity;1283;240;300;540;1
31;78;reciprocity;1101;320;220;540;1
31;79;empathy;680;160;360;520;1
31;80;empathy;1166;300;240;540;1
31;81;empathy;1339;240;300;540;1
31;82;reciprocity;1163;380;60;440;1
31;83;reciprocity;1969;160;360;520;1
31;84;reciprocity;1124;20;380;400;1
32;1;empathy;1929;380;20;400;0
32;2;empathy;2714;240;300;540;1
32;3;empathy;1367;180;340;520;1
32;4;reciprocity;977;60;380;440;1
32;5;reciprocity;1989;380;20;400;1
32;6;reciprocity;2275;360;120;480;0
32;7;reciprocity;957;100;380;480;1
32;8;reciprocity;1798;160;360;520;1
32;9;reciprocity;2322;380;40;420;0
32;10;empathy;1705;380;100;480;1
32;11;empathy;2043;380;20;400;0
32;12;empathy;1621;280;280;560;1
32;13;empathy;1884;60;380;440;1
32;14;empathy;2589;320;220;540;0
32;15;empathy;2314;300;240;540;1
32;16;reciprocity;1632;280;280;560;1
32;17;reciprocity;1926;180;340;520;1
32;19;reciprocity;1899;380;40;420;0
32;20;reciprocity;2761;360;160;520;1
32;22;empathy;3061;340;180;520;1
32;24;empathy;2314;120;360;480;1
32;25;reciprocity;2181;100;380;480;1
32;26;reciprocity;2217;360;160;520;1
32;27;reciprocity;1912;220;320;540;1
32;28;reciprocity;2668;380;60;440;1
32;29;reciprocity;2207;20;380;400;1
32;30;reciprocity;1528;320;220;540;1
32;31;empathy;1745;220;320;540;1
32;32;empathy;2651;380;60;440;0
32;34;reciprocity;1215;220;320;540;1
32;35;reciprocity;1927;240;300;540;1
32;36;reciprocity;2872;340;180;520;0
32;37;reciprocity;2280;380;100;480;1
32;38;reciprocity;1712;160;360;520;1
32;39;reciprocity;1753;300;240;540;1
32;40;empathy;1924;180;340;520;1
32;41;empathy;2446;360;160;520;1
32;42;empathy;2077;360;120;480;1
32;43;reciprocity;2188;340;180;520;0
32;44;reciprocity;1939;300;240;540;1
32;45;reciprocity;2337;280;280;560;1
32;46;reciprocity;3070;380;20;400;0
32;47;reciprocity;1006;120;360;480;1
32;48;reciprocity;1144;240;300;540;1
32;49;empathy;2154;360;120;480;1
32;50;empathy;903;320;220;540;1
32;51;empathy;1057;300;240;540;1
32;52;reciprocity;1384;180;340;520;1
32;53;reciprocity;1996;380;100;480;0
32;56;empathy;924;20;380;400;1
32;57;empathy;1462;20;380;400;1
32;58;reciprocity;1435;320;220;540;1
32;60;reciprocity;1281;40;380;420;1
32;61;empathy;2288;340;180;520;1
32;62;empathy;1139;160;360;520;1
32;63;empathy;871;40;380;420;1
32;64;empathy;956;120;360;480;1
32;65;empathy;2257;380;100;480;0
32;66;empathy;1143;240;300;540;1
32;67;empathy;1762;360;160;520;1
32;68;empathy;2196;40;380;420;1
32;69;empathy;971;100;380;480;1
32;70;empathy;1075;160;360;520;1
32;71;empathy;1137;100;380;480;1
32;72;empathy;2817;380;40;420;0
32;74;empathy;2113;380;60;440;0
32;75;empathy;1306;280;280;560;1
32;76;reciprocity;845;40;380;420;1
32;77;reciprocity;2754;380;60;440;1
32;78;reciprocity;1423;120;360;480;1
32;79;reciprocity;2292;60;380;440;1
32;80;reciprocity;2075;360;120;480;0
32;81;reciprocity;928;20;380;400;1
32;82;empathy;2536;380;40;420;1
32;83;empathy;1479;220;320;540;1
32;84;empathy;1064;60;380;440;1
33;1;empathy;1563;240;300;540;1
33;2;empathy;1644;220;320;540;1
33;3;empathy;2711;300;240;540;0
33;4;reciprocity;1230;380;60;440;1
33;5;reciprocity;1065;20;380;400;1
33;6;reciprocity;1294;40;380;420;1
33;7;empathy;1028;100;380;480;1
33;8;empathy;1042;20;380;400;1
33;10;reciprocity;2187;340;180;520;0
33;11;reciprocity;1369;180;340;520;1
33;12;reciprocity;1163;100;380;480;1
33;13;empathy;1204;340;180;520;0
33;14;empathy;1541;240;300;540;1
33;15;empathy;2764;380;60;440;0
33;16;empathy;1137;40;380;420;1
33;17;empathy;1295;380;40;420;0
33;18;empathy;2086;300;240;540;0
33;19;empathy;1224;220;320;540;1
33;20;empathy;977;40;380;420;1
33;21;empathy;1301;120;360;480;1
33;22;empathy;907;100;380;480;1
33;23;empathy;2492;360;160;520;0
33;24;empathy;897;60;380;440;1
33;25;reciprocity;1883;380;40;420;0
33;26;reciprocity;763;120;360;480;1
33;27;reciprocity;3359;300;240;540;1
33;28;reciprocity;3018;320;220;540;1
33;29;reciprocity;1993;160;360;520;1
33;30;reciprocity;894;60;380;440;1
33;31;reciprocity;2412;360;120;480;0
33;33;reciprocity;754;240;300;540;1
33;34;empathy;1035;320;220;540;0
33;35;empathy;839;280;280;560;1
33;36;empathy;827;60;380;440;1
33;37;reciprocity;1829;380;40;420;0
33;38;reciprocity;3374;360;160;520;0
33;40;reciprocity;783;20;380;400;1
33;41;reciprocity;909;120;360;480;1
33;42;reciprocity;1457;360;160;520;0
33;44;empathy;963;360;120;480;1
33;45;empathy;1977;380;40;420;0
33;46;empathy;987;340;180;520;1
33;47;empathy;889;280;280;560;1
33;48;empathy;773;180;340;520;1
33;49;empathy;739;120;360;480;1
33;50;empathy;1475;380;100;480;0
33;51;empathy;979;180;340;520;1
33;52;empathy;758;20;380;400;1
33;53;empathy;1704;380;100;480;0
33;54;empathy;2230;360;120;480;0
33;55;reciprocity;1387;360;120;480;0
33;57;reciprocity;2823;380;60;440;0
33;58;reciprocity;2671;280;280;560;1
33;59;reciprocity;2752;300;240;540;1
33;60;reciprocity;1342;240;300;540;1
33;61;empathy;1048;160;360;520;1
33;62;empathy;1846;380;60;440;0
33;63;empathy;962;160;360;520;1
33;64;reciprocity;1687;340;180;520;0
33;65;reciprocity;1650;380;20;400;1
33;67;empathy;1965;380;20;400;0
33;68;empathy;1252;360;160;520;0
33;70;reciprocity;998;180;340;520;1
33;71;reciprocity;1871;160;360;520;1
33;72;reciprocity;1909;380;100;480;0
33;73;reciprocity;2351;220;320;540;1
33;74;reciprocity;1979;280;280;560;1
33;75;reciprocity;2716;320;220;540;1
33;76;empathy;839;320;220;540;1
33;78;empathy;2179;380;20;400;0
33;79;reciprocity;1719;100;380;480;1
33;80;reciprocity;2466;380;100;480;0
33;81;reciprocity;1089;380;20;400;0
33;82;reciprocity;780;60;380;440;1
33;83;reciprocity;1172;40;380;420;1
33;84;reciprocity;866;220;320;540;1
